//MAP CONVERTED BY dmm2tgm.py THIS HEADER COMMENT PREVENTS RECONVERSION, DO NOT REMOVE
"a" = (
/turf/closed/mineral/smooth/desertdamrockwall,
/area/space)
"b" = (
/obj/structure/desertdam/decals/road/edge,
/turf/open/floor/plating/ground/desertdam/asphalt,
/area/space)
"c" = (
/obj/structure/desertdam/decals/road/edge{
	dir = 1
	},
/turf/open/floor/plating/ground/desertdam/asphalt,
/area/space)
"d" = (
/obj/machinery/camera/autoname/mainship{
	dir = 1
	},
/turf/open/floor/plating/ground/concrete/autosmooth,
/area/space)
"e" = (
/obj/structure/desertdam/decals/road{
	dir = 4
	},
/turf/open/floor/plating/ground/desertdam/asphalt,
/area/space)
"f" = (
/obj/machinery/camera/autoname/mainship{
	dir = 8
	},
/turf/open/floor/plating/ground/mars/random/sand,
/area/space)
"g" = (
/obj/effect/forcefield,
/obj/structure/prop/mainship/invincibleshutter{
	dir = 4
	},
/turf/open/floor/plating/ground/desertdam/asphalt,
/area/space)
"h" = (
/obj/effect/forcefield,
/obj/structure/desertdam/decals/road{
	dir = 1
	},
/obj/structure/prop/mainship/invincibleshutter{
	dir = 4
	},
/turf/open/floor/plating/ground/desertdam/asphalt,
/area/space)
"i" = (
/obj/structure/desertdam/decals/road/edge{
	dir = 8
	},
/turf/open/floor/plating/ground/desertdam/asphalt,
/area/space)
"j" = (
/obj/effect/forcefield,
/obj/structure/desertdam/decals/road{
	dir = 4
	},
/obj/structure/prop/mainship/invincibleshutter,
/turf/open/floor/plating/ground/desertdam/asphalt,
/area/space)
"k" = (
/turf/open/floor/plating/ground/desertdam/asphalt,
/area/space)
"l" = (
/obj/effect/turf_decal/warning_stripes/thin,
/turf/open/floor/plating/ground/desertdam/asphalt,
/area/space)
"m" = (
/obj/effect/forcefield,
/obj/structure/prop/mainship/invincibleshutter,
/turf/open/floor/plating/ground/desertdam/asphalt,
/area/space)
"n" = (
/turf/open/floor/plating/ground/mars/random/sand,
/area/space)
"o" = (
/obj/structure/desertdam/decals/road/line{
	dir = 1
	},
/turf/open/floor/plating/ground/desertdam/asphalt,
/area/space)
"p" = (
/obj/effect/landmark/start/job/squadcorpsman,
/turf/open/floor/plating/ground/concrete/autosmooth,
/area/space)
"q" = (
/obj/effect/turf_decal/warning_stripes/thin{
	dir = 1
	},
/turf/open/floor/plating/ground/desertdam/asphalt,
/area/space)
"r" = (
/obj/effect/turf_decal/warning_stripes/thin{
	dir = 8
	},
/turf/open/floor/plating/ground/desertdam/asphalt,
/area/space)
"s" = (
/obj/structure/desertdam/decals/road,
/turf/open/floor/plating/ground/desertdam/asphalt,
/area/space)
"t" = (
/obj/effect/forcefield,
/obj/structure/desertdam/decals/road{
	dir = 8
	},
/turf/open/floor/plating/ground/desertdam/asphalt,
/area/space)
"u" = (
/obj/machinery/floodlight/outpost/oscar,
/turf/open/floor/plating/ground/mars/random/sand,
/area/space)
"v" = (
/obj/structure/desertdam/decals/road{
	dir = 8
	},
/turf/open/floor/plating/ground/desertdam/asphalt,
/area/space)
"w" = (
/obj/effect/landmark/start/job/squadengineer,
/turf/open/floor/plating/ground/concrete/autosmooth,
/area/space)
"x" = (
/obj/effect/landmark/start/latejoin,
/turf/open/floor/plating/ground/concrete/autosmooth,
/area/space)
"z" = (
/obj/effect/forcefield,
/turf/open/floor/plating/ground/desertdam/asphalt,
/area/space)
"A" = (
/obj/effect/landmark/start/job/crash/squadleader,
/turf/open/floor/plating/ground/concrete/autosmooth,
/area/space)
"B" = (
/obj/effect/forcefield,
/obj/structure/desertdam/decals/road{
	dir = 4
	},
/turf/open/floor/plating/ground/desertdam/asphalt,
/area/space)
"C" = (
/obj/structure/desertdam/decals/road{
	dir = 1
	},
/turf/open/floor/plating/ground/desertdam/asphalt,
/area/space)
"D" = (
/obj/machinery/miner/damaged/platinum,
/turf/open/floor/plating/ground/mars/random/sand,
/area/space)
"E" = (
/obj/structure/desertdam/decals/road/edge/long{
	dir = 1
	},
/turf/open/floor/plating/ground/desertdam/asphalt,
/area/space)
"F" = (
/obj/structure/prop/vehicle/truck,
/turf/open/floor/plating/ground/desertdam/asphalt,
/area/space)
"G" = (
/obj/machinery/miner/damaged,
/turf/open/floor/plating/ground/mars/random/sand,
/area/space)
"H" = (
/turf/closed/mineral/smooth/desertdamrockwall/indestructible,
/area/space)
"I" = (
/turf/open/floor/plating,
/area/space)
"J" = (
/obj/machinery/camera/autoname/mainship{
	dir = 4
	},
/turf/open/floor/plating/ground/mars/random/sand,
/area/space)
"K" = (
/turf/closed/wall/r_wall,
/area/space)
"L" = (
/obj/effect/turf_decal/warning_stripes/thin{
	dir = 4
	},
/turf/open/floor/plating/ground/desertdam/asphalt,
/area/space)
"M" = (
/obj/machinery/landinglight/alamo{
	dir = 4
	},
/turf/open/floor/plating/ground/mars/random/sand,
/area/space)
"N" = (
/obj/effect/landmark/start/job/crash/squadsmartgunner,
/turf/open/floor/plating/ground/concrete/autosmooth,
/area/space)
"O" = (
/obj/machinery/landinglight/alamo{
	dir = 8
	},
/turf/open/floor/plating/ground/mars/random/sand,
/area/space)
"P" = (
/turf/open/floor/plating/ground/concrete/autosmooth,
/area/space)
"Q" = (
/obj/machinery/landinglight/alamo{
	dir = 1
	},
/turf/open/floor/plating/ground/mars/random/sand,
/area/space)
"R" = (
/obj/machinery/camera/autoname/mainship,
/turf/open/floor/plating/ground/concrete/autosmooth,
/area/space)
"S" = (
/obj/docking_port/stationary/marine_dropship/hangar/one,
/turf/open/floor/plating,
/area/space)
"T" = (
/obj/structure/desertdam/decals/road/edge/long,
/turf/open/floor/plating/ground/desertdam/asphalt,
/area/space)
"U" = (
/obj/effect/forcefield,
/obj/structure/desertdam/decals/road,
/obj/structure/prop/mainship/invincibleshutter{
	dir = 4
	},
/turf/open/floor/plating/ground/desertdam/asphalt,
/area/space)
"V" = (
/mob/living/silicon/ai/malf,
/turf/open/floor/plating/ground/concrete/autosmooth,
/area/space)
"W" = (
/obj/structure/desertdam/decals/road/edge/long{
	dir = 4
	},
/turf/open/floor/plating/ground/desertdam/asphalt,
/area/space)
"Y" = (
/obj/effect/forcefield,
/obj/structure/desertdam/decals/road{
	dir = 8
	},
/obj/structure/prop/mainship/invincibleshutter,
/turf/open/floor/plating/ground/desertdam/asphalt,
/area/space)
"Z" = (
/obj/machinery/landinglight/alamo,
/turf/open/floor/plating/ground/mars/random/sand,
/area/space)

(1,1,1) = {"
H
H
H
H
H
H
H
H
H
H
H
H
H
H
H
H
H
H
H
H
H
H
H
H
H
H
H
H
H
H
H
H
H
H
H
H
H
H
H
H
H
H
H
H
H
H
H
H
H
H
H
H
H
H
H
H
H
H
H
H
H
H
H
H
H
H
H
H
H
H
H
H
H
H
H
H
H
H
H
H
"}
(2,1,1) = {"
H
a
a
a
a
a
a
a
a
a
a
a
a
a
a
a
a
a
a
a
a
a
a
a
a
a
a
a
a
a
a
a
a
a
a
a
a
a
a
a
a
a
a
a
a
a
a
a
a
a
a
a
a
a
a
a
a
a
a
a
a
a
a
a
a
a
a
a
a
a
a
a
a
a
a
a
a
a
a
H
"}
(3,1,1) = {"
H
a
a
a
a
a
a
a
a
a
a
a
a
a
a
a
a
a
a
a
a
a
a
a
a
a
a
a
a
a
a
a
a
a
a
a
a
a
a
a
a
a
a
a
a
a
a
a
a
a
a
a
a
a
a
a
a
a
a
a
a
a
a
a
a
a
a
a
a
a
a
a
a
a
a
a
a
a
a
H
"}
(4,1,1) = {"
H
a
a
a
a
a
a
a
a
a
a
a
a
a
a
a
a
a
a
a
a
a
a
a
a
a
a
a
a
a
a
a
a
a
a
a
a
a
a
a
a
a
n
n
n
n
n
a
a
a
a
a
a
a
a
n
n
a
a
a
a
a
n
n
n
a
a
a
n
J
n
a
a
a
a
a
a
a
a
H
"}
(5,1,1) = {"
H
a
a
a
a
a
a
a
a
a
a
a
a
a
a
a
a
a
a
a
a
a
a
a
a
a
a
a
a
a
a
a
a
a
n
n
n
n
n
n
n
n
n
n
n
n
n
n
a
a
a
a
n
n
n
n
n
n
n
n
n
n
n
n
n
n
n
n
n
n
n
a
a
a
a
a
a
a
a
H
"}
(6,1,1) = {"
H
a
a
a
a
a
a
n
n
n
a
a
a
a
a
a
a
a
a
a
a
a
a
a
a
a
n
a
a
a
a
a
n
n
n
n
n
n
n
n
n
n
n
n
n
n
n
n
n
a
a
n
n
n
n
n
n
n
n
n
n
n
n
n
n
n
n
n
n
n
n
n
n
n
a
a
a
a
a
H
"}
(7,1,1) = {"
H
a
a
a
n
n
n
n
n
n
n
n
a
a
a
a
a
a
a
a
a
a
a
a
n
n
n
n
a
a
a
n
n
n
n
n
n
n
n
n
n
n
n
n
n
n
n
n
n
n
n
n
n
n
n
n
n
n
n
n
n
n
n
n
n
P
P
P
P
P
P
P
P
P
P
n
a
a
a
H
"}
(8,1,1) = {"
H
a
a
n
n
n
n
n
n
n
n
n
n
n
n
n
n
a
a
a
n
n
n
n
n
n
n
n
n
n
n
n
n
n
n
n
n
n
n
n
n
n
n
n
n
n
n
n
n
n
n
n
n
n
n
n
n
n
n
n
n
n
n
n
n
P
P
P
P
P
P
P
P
P
P
n
n
a
a
H
"}
(9,1,1) = {"
H
a
a
n
n
n
n
n
n
n
n
n
n
n
n
n
n
n
n
n
n
n
n
n
n
n
n
n
n
n
n
n
n
n
n
n
n
n
n
n
n
n
n
n
n
n
n
n
n
n
n
n
n
n
n
n
n
n
n
n
n
n
n
n
n
P
P
P
P
P
P
P
P
P
P
n
n
a
a
H
"}
(10,1,1) = {"
H
a
n
n
n
n
n
n
n
n
n
n
n
n
n
n
n
n
n
n
n
n
n
n
n
n
n
n
n
n
n
n
n
n
n
n
n
n
n
n
n
n
n
n
n
n
n
n
n
n
n
n
n
n
n
n
n
n
n
n
n
n
n
n
n
P
P
P
P
P
P
P
P
P
P
n
n
n
a
H
"}
(11,1,1) = {"
H
a
n
n
n
n
n
n
n
n
n
n
n
n
n
n
n
n
n
n
n
n
n
n
n
n
n
n
n
n
n
n
n
n
n
n
n
n
n
n
n
n
n
n
n
n
n
n
n
n
n
n
n
n
n
n
n
n
n
n
n
n
n
n
n
P
P
P
P
P
P
P
P
P
P
n
n
n
a
H
"}
(12,1,1) = {"
H
a
n
n
n
n
n
n
G
n
n
n
n
n
n
n
n
n
n
n
n
n
n
n
n
n
n
n
n
n
n
n
n
n
n
n
n
n
n
n
n
n
n
n
n
n
n
n
n
n
n
n
n
n
n
n
n
n
n
n
n
n
n
n
n
P
P
P
P
P
P
P
P
P
P
u
n
n
a
H
"}
(13,1,1) = {"
H
a
n
n
n
n
n
n
n
n
n
n
n
n
n
n
n
n
n
n
n
n
n
n
n
n
n
n
n
n
n
n
n
n
n
n
n
n
n
n
n
n
n
n
n
n
n
n
n
n
n
n
n
n
n
n
n
n
n
n
n
n
n
n
n
P
P
P
P
P
P
P
P
P
P
n
n
n
a
H
"}
(14,1,1) = {"
H
a
a
n
n
n
n
n
u
n
n
n
n
n
n
n
a
a
a
a
a
a
a
n
n
n
n
n
n
n
n
n
n
n
n
n
n
n
n
n
n
n
n
n
n
n
n
n
n
n
n
n
n
n
n
n
n
n
n
n
n
n
n
n
n
P
P
P
P
P
P
P
P
P
P
n
n
n
a
H
"}
(15,1,1) = {"
H
a
a
a
n
n
n
n
n
n
n
n
n
n
a
a
a
a
a
a
a
a
a
a
n
n
n
n
n
n
n
n
n
n
n
n
n
n
n
n
n
n
n
n
n
n
n
n
n
n
n
n
n
n
n
n
n
n
n
n
n
n
n
n
n
n
n
n
n
n
n
n
n
n
n
n
n
n
K
H
"}
(16,1,1) = {"
H
a
a
a
n
n
n
n
n
n
n
n
n
a
a
a
a
a
a
a
a
a
a
a
a
a
n
n
n
n
n
n
a
a
a
n
n
n
n
n
n
n
n
n
n
n
n
n
n
n
n
n
n
n
n
n
n
n
n
n
T
v
v
v
v
v
v
v
v
v
v
v
v
v
v
v
v
v
Y
t
"}
(17,1,1) = {"
H
a
a
a
n
n
n
n
n
n
n
n
a
a
a
a
a
a
a
a
a
a
a
a
a
a
a
a
a
a
n
a
a
a
a
n
n
n
n
n
n
n
n
n
n
n
n
n
n
n
n
n
n
n
n
n
n
n
n
n
C
k
k
L
k
k
L
k
k
L
k
k
L
k
k
L
k
k
m
z
"}
(18,1,1) = {"
H
a
a
K
P
P
P
P
P
P
P
P
a
a
a
a
a
a
a
a
a
a
a
a
a
a
a
a
a
a
a
a
a
a
a
a
n
n
n
n
n
n
n
n
n
n
n
n
n
n
n
n
n
n
n
n
n
n
n
n
C
k
k
r
k
k
r
k
k
r
k
k
r
k
k
r
k
k
m
z
"}
(19,1,1) = {"
H
a
a
K
P
P
P
P
P
P
P
P
a
a
a
a
a
a
a
a
a
a
a
a
a
a
a
a
a
a
a
a
a
a
a
a
n
n
n
n
n
n
n
n
n
n
n
n
n
n
n
n
n
n
n
n
n
n
n
n
C
k
k
b
e
e
e
e
e
e
e
e
e
e
e
e
e
e
j
B
"}
(20,1,1) = {"
H
a
a
K
P
P
P
P
P
P
P
P
P
a
a
a
a
a
a
a
a
a
a
a
a
a
a
a
a
a
a
a
a
a
a
a
n
n
n
n
n
n
n
n
n
n
n
n
n
n
n
n
n
n
n
n
n
n
n
n
C
l
q
s
n
n
n
n
n
n
n
n
n
n
n
n
n
n
K
H
"}
(21,1,1) = {"
H
a
a
K
P
P
P
P
P
P
P
P
P
P
a
a
a
a
a
a
a
a
a
a
a
a
a
a
a
a
a
a
a
a
a
n
n
n
n
n
n
n
n
n
n
n
n
n
n
n
n
n
n
n
n
n
n
n
n
n
C
k
k
s
n
n
n
n
n
n
n
n
n
n
n
n
n
a
a
H
"}
(22,1,1) = {"
H
a
a
K
P
P
P
P
P
P
P
P
P
P
P
a
a
a
a
a
a
a
a
a
a
a
a
a
a
a
a
a
a
a
n
n
n
n
n
n
n
n
n
n
n
n
n
n
n
n
n
n
n
n
n
n
n
n
n
n
C
k
k
s
n
n
n
n
n
n
n
n
n
n
n
n
a
a
a
H
"}
(23,1,1) = {"
H
a
a
K
P
P
P
P
P
P
P
P
P
P
P
a
a
a
a
a
a
a
a
a
a
a
a
a
a
a
a
a
a
n
n
n
n
n
n
n
n
n
n
n
n
n
n
n
n
n
n
n
n
n
n
n
n
n
n
n
C
l
q
s
n
n
n
n
n
n
n
n
n
n
n
n
a
a
a
H
"}
(24,1,1) = {"
H
a
a
K
P
P
P
P
P
P
P
P
P
P
P
a
a
a
a
a
a
a
a
a
a
a
a
a
a
a
a
a
n
n
n
n
n
n
n
n
n
n
n
n
n
n
n
n
n
n
n
n
n
n
n
n
n
n
n
n
C
k
k
s
n
n
n
n
n
n
n
n
n
n
n
n
a
a
a
H
"}
(25,1,1) = {"
H
a
a
K
P
P
P
P
P
P
P
P
P
P
P
a
a
a
a
a
a
a
a
a
a
a
a
a
a
a
a
a
n
n
n
n
n
n
n
n
n
n
n
n
n
n
n
n
n
n
n
n
n
n
n
n
n
n
n
n
C
k
k
s
n
n
n
n
n
n
n
n
n
n
n
n
n
a
a
H
"}
(26,1,1) = {"
H
a
a
K
P
P
P
P
P
P
P
P
P
P
P
a
a
a
a
a
a
a
a
a
a
a
a
a
a
a
a
n
n
n
n
n
n
n
n
n
n
n
n
n
n
n
n
n
n
n
n
n
n
n
n
n
n
n
n
n
C
l
q
s
n
n
n
n
n
n
n
n
n
n
n
n
n
a
a
H
"}
(27,1,1) = {"
H
a
a
K
P
P
P
P
P
P
P
P
P
P
P
a
a
a
a
a
a
a
a
a
a
a
a
a
a
a
a
n
n
n
n
n
n
n
n
n
n
n
n
n
n
n
n
n
n
n
n
n
n
n
n
n
n
n
n
n
C
k
k
s
n
n
n
n
n
n
n
n
n
n
n
n
n
n
a
H
"}
(28,1,1) = {"
H
a
a
K
R
P
P
P
x
V
P
P
P
P
d
a
a
a
a
a
a
a
a
a
a
a
a
a
a
a
n
n
n
n
n
n
n
n
n
n
n
n
n
n
n
n
n
n
n
n
n
n
n
n
n
n
n
n
n
n
C
k
k
s
n
n
n
n
n
n
n
n
n
n
n
n
n
n
a
H
"}
(29,1,1) = {"
H
a
a
K
P
w
N
P
P
P
P
P
P
P
a
a
a
a
a
a
a
a
a
a
a
a
a
a
n
n
n
n
n
n
n
n
n
n
n
n
n
n
n
n
n
n
n
n
n
n
n
n
n
n
n
n
n
n
n
n
C
l
q
s
n
n
n
n
n
n
n
n
n
n
n
n
n
n
a
H
"}
(30,1,1) = {"
H
a
a
K
P
p
A
P
P
P
P
P
P
P
a
a
a
a
a
a
a
a
a
a
a
a
a
n
n
n
n
n
n
n
n
n
n
n
n
n
n
n
n
n
n
n
n
n
n
n
n
n
n
n
n
n
n
n
n
n
C
k
k
s
n
n
n
n
n
n
n
n
n
n
n
n
n
n
a
H
"}
(31,1,1) = {"
H
a
a
K
P
w
N
P
P
P
P
P
P
P
a
a
a
a
a
a
a
a
a
a
a
a
n
n
n
n
n
n
n
n
n
n
n
n
n
n
n
n
n
n
n
n
n
n
n
n
n
n
n
n
n
n
n
n
n
n
C
k
k
s
n
n
n
n
n
n
n
n
n
n
n
n
n
n
a
H
"}
(32,1,1) = {"
H
a
a
K
P
p
A
P
P
P
P
P
P
P
P
a
a
a
a
a
a
a
a
a
a
n
n
n
n
n
n
n
n
n
n
n
n
n
n
n
n
n
n
n
n
n
n
n
n
n
n
n
n
n
n
n
n
n
n
n
C
l
q
s
n
n
n
n
n
n
n
n
n
n
n
n
n
n
a
H
"}
(33,1,1) = {"
H
a
a
K
P
w
N
P
P
P
P
P
P
P
P
a
a
a
a
a
a
a
a
a
v
v
v
v
v
v
v
v
v
v
v
v
v
v
v
v
v
v
v
v
v
v
v
v
v
v
v
v
v
v
v
v
v
v
v
v
c
k
k
s
n
n
n
n
n
n
n
n
n
n
n
n
n
n
a
H
"}
(34,1,1) = {"
H
a
a
K
P
p
A
P
P
P
P
P
P
P
P
a
a
a
a
a
a
a
a
a
L
k
k
L
k
k
L
k
k
L
k
k
L
k
k
L
k
k
L
k
k
L
k
k
L
k
k
L
k
k
k
L
k
k
L
k
k
L
k
s
n
n
n
n
n
n
n
n
n
n
n
n
n
n
n
H
"}
(35,1,1) = {"
H
a
a
K
P
w
N
P
P
P
P
P
P
P
P
a
a
a
a
a
a
a
a
a
r
k
k
r
k
k
r
k
k
r
k
k
r
k
k
r
k
k
r
k
k
r
k
k
r
k
k
r
k
k
k
r
k
k
r
k
k
r
k
s
n
n
n
n
n
n
n
n
n
n
n
n
n
n
n
H
"}
(36,1,1) = {"
H
a
a
K
P
P
P
P
P
P
P
P
P
P
P
K
a
a
a
a
a
a
a
a
e
e
e
e
e
e
e
e
e
e
e
e
e
e
e
e
e
e
e
e
e
e
e
i
k
k
b
e
e
e
e
e
e
e
e
e
e
e
e
W
n
n
n
n
n
n
n
n
n
n
n
n
n
n
a
H
"}
(37,1,1) = {"
H
a
a
K
P
P
P
P
P
P
P
P
P
P
P
K
a
a
a
a
a
a
a
a
n
n
n
n
n
n
n
n
n
n
n
n
n
n
n
n
n
n
n
n
n
n
n
C
l
q
s
n
n
n
n
n
n
n
n
n
n
n
n
n
n
n
n
n
n
n
n
n
n
n
n
n
n
a
a
H
"}
(38,1,1) = {"
H
a
a
K
P
P
P
P
P
P
P
P
P
P
P
a
a
a
a
a
a
a
a
a
a
a
n
n
n
n
n
n
n
n
n
n
n
n
n
n
n
n
n
n
n
n
n
C
k
k
s
n
n
n
n
n
n
n
n
n
n
n
n
n
n
n
n
n
n
n
n
n
n
n
n
n
n
a
a
H
"}
(39,1,1) = {"
H
a
a
a
a
n
n
n
n
n
n
n
n
n
n
a
a
a
a
a
a
a
a
a
a
a
a
n
n
n
n
n
n
n
n
n
n
n
n
n
n
n
n
n
n
n
n
C
k
k
s
n
n
n
n
n
n
n
n
n
n
n
n
n
n
n
n
n
n
n
n
n
n
n
n
n
n
a
a
H
"}
(40,1,1) = {"
H
a
a
a
a
n
n
n
n
n
n
n
n
n
a
a
a
a
a
a
a
a
a
a
a
a
a
n
n
n
n
n
n
n
n
n
n
n
n
n
n
n
n
n
n
n
n
C
l
q
s
n
n
n
n
n
n
n
n
n
n
n
n
n
n
n
n
n
n
n
n
n
n
n
n
n
n
a
a
H
"}
(41,1,1) = {"
H
a
a
a
a
n
n
n
n
n
n
n
n
n
a
a
a
a
a
a
a
a
a
a
a
a
a
n
n
n
n
n
n
n
n
n
n
n
n
n
n
n
n
n
n
n
n
C
k
k
s
n
n
n
n
n
n
n
n
n
n
n
n
n
n
n
n
n
n
n
n
n
n
n
n
n
n
a
a
H
"}
(42,1,1) = {"
H
a
a
a
a
n
n
n
n
n
n
n
n
n
a
a
a
a
a
a
a
a
a
a
a
a
a
n
n
n
n
n
n
n
n
n
n
n
n
n
n
n
n
n
n
n
n
C
k
k
s
n
n
n
n
n
n
n
n
n
n
n
n
n
n
n
n
n
n
n
n
n
n
n
n
n
n
a
a
H
"}
(43,1,1) = {"
H
a
a
a
a
n
n
n
n
n
n
n
n
a
a
a
a
a
a
a
a
a
a
a
a
a
n
n
n
n
n
n
n
n
n
n
n
n
n
n
n
n
n
n
n
n
n
C
l
q
s
n
n
n
M
M
M
M
M
M
M
M
M
M
M
M
M
M
M
M
M
M
M
M
M
n
n
a
a
H
"}
(44,1,1) = {"
H
a
a
a
n
n
n
n
n
n
n
n
n
a
a
a
a
a
a
a
a
a
a
a
a
n
n
n
n
n
n
n
n
n
n
n
n
n
n
n
n
n
n
n
T
v
v
c
k
k
s
n
n
Z
I
I
I
I
I
I
I
I
I
I
I
I
I
I
I
I
I
I
I
I
I
Q
n
a
a
H
"}
(45,1,1) = {"
H
a
a
a
a
n
n
n
n
n
n
n
n
n
a
a
a
a
a
a
a
a
a
a
n
n
n
n
n
n
n
n
n
n
n
n
n
n
n
n
n
n
n
n
C
k
k
o
k
k
s
n
n
Z
I
I
I
I
I
I
I
I
I
I
I
I
I
I
I
I
I
I
I
I
I
Q
n
n
a
H
"}
(46,1,1) = {"
H
a
a
a
a
n
n
n
n
n
n
n
n
n
n
n
n
a
a
a
a
a
a
n
n
n
n
n
n
n
n
n
n
n
n
n
n
n
n
n
n
n
n
n
C
F
k
o
l
q
s
n
n
Z
I
I
I
I
I
I
I
I
I
I
I
I
I
I
I
I
I
I
I
I
I
Q
n
n
a
H
"}
(47,1,1) = {"
H
a
a
a
n
n
n
n
n
n
n
n
n
n
n
n
n
n
n
n
n
n
n
n
n
n
n
n
n
n
n
n
n
n
n
n
n
n
n
n
n
n
n
n
C
k
k
o
k
k
s
n
n
Z
I
I
I
I
I
I
I
I
I
I
I
I
I
I
I
I
I
I
I
I
I
Q
n
n
a
H
"}
(48,1,1) = {"
H
a
a
n
n
n
n
n
u
n
n
n
n
n
n
n
n
n
n
n
n
n
n
n
n
n
n
n
n
n
n
n
n
n
n
n
n
n
n
n
n
n
n
n
C
k
k
o
k
k
s
n
n
Z
I
I
I
I
I
I
I
I
I
I
I
I
I
I
I
I
I
I
I
I
I
Q
n
a
a
H
"}
(49,1,1) = {"
H
a
a
n
n
n
n
n
n
n
n
n
n
n
n
n
n
n
n
n
n
n
n
n
n
n
n
n
n
n
n
n
n
n
n
n
n
n
n
n
n
n
n
n
C
k
k
o
l
q
s
n
n
Z
I
I
I
I
I
I
I
I
I
I
S
I
I
I
I
I
I
I
I
I
I
Q
n
a
a
H
"}
(50,1,1) = {"
H
a
a
n
n
n
n
n
D
n
n
n
n
n
n
n
n
n
n
n
n
n
n
n
n
n
n
n
n
n
n
n
n
n
n
n
n
n
n
n
n
n
n
n
E
e
e
i
k
k
s
n
n
Z
I
I
I
I
I
I
I
I
I
I
I
I
I
I
I
I
I
I
I
I
I
Q
n
a
a
H
"}
(51,1,1) = {"
H
a
a
n
n
n
n
n
n
n
n
n
n
n
n
n
n
n
n
n
n
n
n
n
n
n
n
n
n
n
n
n
n
n
n
n
n
n
n
n
n
n
n
n
n
n
n
C
k
k
s
n
n
Z
I
I
I
I
I
I
I
I
I
I
I
I
I
I
I
I
I
I
I
I
I
Q
n
a
a
H
"}
(52,1,1) = {"
H
a
a
a
n
n
n
n
n
n
n
n
n
n
n
n
a
n
n
n
n
n
n
n
n
n
n
n
n
n
n
n
n
n
n
n
n
n
n
n
n
n
n
n
n
n
n
C
l
q
s
n
n
Z
I
I
I
I
I
I
I
I
I
I
I
I
I
I
I
I
I
I
I
I
I
Q
n
a
a
H
"}
(53,1,1) = {"
H
a
a
a
n
n
n
n
n
n
n
n
n
n
a
a
a
a
a
a
n
n
a
a
a
a
n
n
n
n
n
n
n
n
n
n
n
n
n
n
n
n
n
n
n
n
n
C
k
k
s
n
n
Z
I
I
I
I
I
I
I
I
I
I
I
I
I
I
I
I
I
I
I
I
I
Q
n
n
a
H
"}
(54,1,1) = {"
H
a
a
a
n
n
n
n
n
n
n
n
n
n
a
a
a
a
a
a
a
a
a
a
a
a
a
n
n
n
n
n
n
n
n
n
n
n
n
n
n
n
n
n
n
n
n
C
k
k
s
n
n
Z
I
I
I
I
I
I
I
I
I
I
I
I
I
I
I
I
I
I
I
I
I
Q
n
n
a
H
"}
(55,1,1) = {"
H
a
a
a
a
n
n
n
n
n
n
n
a
a
a
a
a
a
a
a
a
a
a
a
a
a
a
a
a
a
n
n
n
n
n
n
n
n
n
n
n
n
n
n
n
n
n
C
l
q
s
n
n
n
O
O
O
O
O
O
O
O
O
O
O
O
O
O
O
O
O
O
O
O
O
n
n
a
a
H
"}
(56,1,1) = {"
H
a
a
a
a
a
n
n
n
n
n
a
a
a
a
a
a
a
a
a
a
a
a
a
a
a
a
a
a
a
a
a
a
a
a
a
a
a
n
n
n
n
n
n
n
n
n
C
k
k
s
n
n
n
n
n
n
n
n
n
n
n
n
n
n
n
n
n
n
n
n
n
n
n
n
n
n
a
a
H
"}
(57,1,1) = {"
H
a
a
a
a
a
a
n
n
n
a
a
a
a
a
a
a
a
a
a
a
a
a
a
a
a
a
a
a
a
a
a
a
a
a
a
a
a
a
a
a
n
n
n
n
n
n
C
k
k
s
n
n
n
n
n
n
n
f
n
n
n
n
n
n
n
n
n
n
f
n
n
n
n
a
a
a
a
a
H
"}
(58,1,1) = {"
H
a
a
a
a
a
a
a
a
a
a
a
a
a
a
a
a
a
a
a
a
a
a
a
a
a
a
a
a
a
a
a
a
a
a
a
a
a
a
a
a
a
a
n
n
n
n
C
l
q
s
n
n
n
a
a
a
a
a
a
a
a
a
a
a
a
a
n
a
a
n
a
a
a
a
a
a
a
a
H
"}
(59,1,1) = {"
H
a
a
a
a
a
a
a
a
a
a
a
a
a
a
a
a
a
a
a
a
a
a
a
a
a
a
a
a
a
a
a
a
a
a
a
a
a
a
a
a
a
a
a
n
n
n
C
k
k
s
n
a
a
a
a
a
a
a
a
a
a
a
a
a
a
a
a
a
a
a
a
a
a
a
a
a
a
a
H
"}
(60,1,1) = {"
H
H
H
H
H
H
H
H
H
H
H
H
H
H
H
H
H
H
H
H
H
H
H
H
H
H
H
H
H
H
H
H
H
H
H
H
H
H
H
H
H
H
H
H
H
H
K
h
g
g
U
K
H
H
H
H
H
H
H
H
H
H
H
H
H
H
H
H
H
H
H
H
H
H
H
H
H
H
H
H
"}
