//MAP CONVERTED BY dmm2tgm.py THIS HEADER COMMENT PREVENTS RECONVERSION, DO NOT REMOVE
"aR" = (
/obj/effect/mapping_helpers/rtsprefab/engineering,
/turf/open/floor/plating/ground/concrete/autosmooth,
/area/mainship/hallways/hangar)
"cj" = (
/turf/closed/wall/r_wall,
/area/mainship/hallways/hangar)
"ec" = (
/obj/machinery/miner/damaged/platinum,
/turf/open/floor/plating/ground/mars/random/sand,
/area/mainship/hallways/hangar)
"hr" = (
/obj/machinery/camera/autoname/mainship,
/turf/open/floor/plating/ground/concrete/autosmooth,
/area/mainship/hallways/hangar)
"iK" = (
/turf/closed/mineral/smooth/desertdamrockwall,
/area/mainship/hallways/hangar)
"iN" = (
/obj/effect/forcefield,
/obj/structure/desertdam/decals/road{
	dir = 4
	},
/turf/open/floor/plating/ground/desertdam/asphalt,
/area/mainship/hallways/hangar)
"jH" = (
/obj/effect/forcefield,
/turf/open/floor/plating/ground/desertdam/asphalt,
/area/mainship/hallways/hangar)
"kQ" = (
/obj/effect/landmark/start/job/squadengineer,
/turf/open/floor/plating/ground/concrete/autosmooth,
/area/mainship/hallways/hangar)
"la" = (
/obj/machinery/camera/autoname/mainship{
	dir = 1
	},
/turf/open/floor/plating/ground/concrete/autosmooth,
/area/mainship/hallways/hangar)
"lb" = (
/obj/structure/desertdam/decals/road/edge{
	dir = 1
	},
/turf/open/floor/plating/ground/desertdam/asphalt,
/area/mainship/hallways/hangar)
"lg" = (
/obj/effect/turf_decal/warning_stripes/thin{
	dir = 4
	},
/turf/open/floor/plating/ground/desertdam/asphalt,
/area/mainship/hallways/hangar)
"lJ" = (
/obj/structure/desertdam/decals/road,
/turf/open/floor/plating/ground/desertdam/asphalt,
/area/mainship/hallways/hangar)
"mi" = (
/obj/effect/forcefield,
/obj/structure/desertdam/decals/road,
/obj/structure/prop/mainship/invincibleshutter{
	dir = 4
	},
/turf/open/floor/plating/ground/desertdam/asphalt,
/area/mainship/hallways/hangar)
"mk" = (
/obj/structure/desertdam/decals/road/edge/long,
/turf/open/floor/plating/ground/desertdam/asphalt,
/area/mainship/hallways/hangar)
"nJ" = (
/obj/structure/desertdam/decals/road{
	dir = 8
	},
/turf/open/floor/plating/ground/desertdam/asphalt,
/area/mainship/hallways/hangar)
"os" = (
/obj/structure/desertdam/decals/road/edge/long{
	dir = 1
	},
/turf/open/floor/plating/ground/desertdam/asphalt,
/area/mainship/hallways/hangar)
"pq" = (
/obj/effect/landmark/start/job/squadcorpsman,
/turf/open/floor/plating/ground/concrete/autosmooth,
/area/mainship/hallways/hangar)
"rc" = (
/obj/machinery/landinglight/alamo{
	dir = 4
	},
/turf/open/floor/plating/ground/mars/random/sand,
/area/mainship/hallways/hangar)
"ro" = (
/obj/effect/turf_decal/warning_stripes/thin,
/turf/open/floor/plating/ground/desertdam/asphalt,
/area/mainship/hallways/hangar)
"rz" = (
/obj/docking_port/stationary/marine_dropship/hangar/one,
/turf/open/floor/plating,
/area/mainship/hallways/hangar)
"sf" = (
/turf/open/floor/plating/ground/mars/random/sand,
/area/mainship/hallways/hangar)
"tH" = (
/obj/effect/landmark/start/latejoin,
/turf/open/floor/plating/ground/concrete/autosmooth,
/area/mainship/hallways/hangar)
"vn" = (
/obj/structure/desertdam/decals/road{
	dir = 1
	},
/turf/open/floor/plating/ground/desertdam/asphalt,
/area/mainship/hallways/hangar)
"vR" = (
/obj/effect/turf_decal/warning_stripes/thin{
	dir = 8
	},
/turf/open/floor/plating/ground/desertdam/asphalt,
/area/mainship/hallways/hangar)
"xe" = (
/obj/effect/forcefield,
/obj/structure/desertdam/decals/road{
	dir = 8
	},
/obj/structure/prop/mainship/invincibleshutter,
/turf/open/floor/plating/ground/desertdam/asphalt,
/area/mainship/hallways/hangar)
"xr" = (
/obj/effect/landmark/start/job/crash/squadsmartgunner,
/turf/open/floor/plating/ground/concrete/autosmooth,
/area/mainship/hallways/hangar)
"zo" = (
/turf/open/floor/plating/ground/desertdam/asphalt,
/area/mainship/hallways/hangar)
"zL" = (
/obj/machinery/miner/damaged,
/turf/open/floor/plating/ground/mars/random/sand,
/area/mainship/hallways/hangar)
"Ar" = (
/obj/effect/mapping_helpers/rtsprefab,
/turf/open/floor/plating/ground/concrete/autosmooth,
/area/mainship/hallways/hangar)
"Bq" = (
/turf/closed/mineral/smooth/desertdamrockwall/indestructible,
/area/mainship/hallways/hangar)
"Cp" = (
/obj/effect/forcefield,
/obj/structure/desertdam/decals/road{
	dir = 1
	},
/obj/structure/prop/mainship/invincibleshutter{
	dir = 4
	},
/turf/open/floor/plating/ground/desertdam/asphalt,
/area/mainship/hallways/hangar)
"Dm" = (
/obj/machinery/camera/autoname/mainship{
	dir = 4
	},
/turf/open/floor/plating/ground/mars/random/sand,
/area/mainship/hallways/hangar)
"FT" = (
/obj/structure/desertdam/decals/road/line{
	dir = 1
	},
/turf/open/floor/plating/ground/desertdam/asphalt,
/area/mainship/hallways/hangar)
"FY" = (
/obj/structure/desertdam/decals/road/edge,
/turf/open/floor/plating/ground/desertdam/asphalt,
/area/mainship/hallways/hangar)
"Gw" = (
/obj/effect/forcefield,
/obj/structure/desertdam/decals/road{
	dir = 4
	},
/obj/structure/prop/mainship/invincibleshutter,
/turf/open/floor/plating/ground/desertdam/asphalt,
/area/mainship/hallways/hangar)
"JM" = (
/obj/structure/prop/vehicle/truck,
/turf/open/floor/plating/ground/desertdam/asphalt,
/area/mainship/hallways/hangar)
"Kc" = (
/turf/open/floor/plating,
/area/mainship/hallways/hangar)
"Lu" = (
/mob/living/silicon/ai/malf,
/turf/open/floor/plating/ground/concrete/autosmooth,
/area/mainship/hallways/hangar)
"Mt" = (
/obj/effect/landmark/start/job/crash/squadleader,
/turf/open/floor/plating/ground/concrete/autosmooth,
/area/mainship/hallways/hangar)
"Oz" = (
/obj/effect/forcefield,
/obj/structure/prop/mainship/invincibleshutter{
	dir = 4
	},
/turf/open/floor/plating/ground/desertdam/asphalt,
/area/mainship/hallways/hangar)
"OV" = (
/obj/structure/desertdam/decals/road/edge{
	dir = 8
	},
/turf/open/floor/plating/ground/desertdam/asphalt,
/area/mainship/hallways/hangar)
"Pl" = (
/obj/structure/desertdam/decals/road/edge/long{
	dir = 4
	},
/turf/open/floor/plating/ground/desertdam/asphalt,
/area/mainship/hallways/hangar)
"Qc" = (
/obj/effect/forcefield,
/obj/structure/desertdam/decals/road{
	dir = 8
	},
/turf/open/floor/plating/ground/desertdam/asphalt,
/area/mainship/hallways/hangar)
"Qf" = (
/obj/structure/desertdam/decals/road{
	dir = 4
	},
/turf/open/floor/plating/ground/desertdam/asphalt,
/area/mainship/hallways/hangar)
"Tx" = (
/obj/machinery/landinglight/alamo,
/turf/open/floor/plating/ground/mars/random/sand,
/area/mainship/hallways/hangar)
"Uh" = (
/obj/effect/forcefield,
/obj/structure/prop/mainship/invincibleshutter,
/turf/open/floor/plating/ground/desertdam/asphalt,
/area/mainship/hallways/hangar)
"Uk" = (
/obj/machinery/floodlight/outpost/oscar,
/turf/open/floor/plating/ground/mars/random/sand,
/area/mainship/hallways/hangar)
"Vr" = (
/obj/effect/mapping_helpers/rtsprefab/powergen,
/turf/open/floor/plating/ground/concrete/autosmooth,
/area/mainship/hallways/hangar)
"VE" = (
/obj/machinery/landinglight/alamo{
	dir = 8
	},
/turf/open/floor/plating/ground/mars/random/sand,
/area/mainship/hallways/hangar)
"VI" = (
/obj/machinery/landinglight/alamo{
	dir = 1
	},
/turf/open/floor/plating/ground/mars/random/sand,
/area/mainship/hallways/hangar)
"VV" = (
/turf/open/floor/plating/ground/concrete/autosmooth,
/area/mainship/hallways/hangar)
"Xb" = (
/obj/machinery/camera/autoname/mainship{
	dir = 8
	},
/turf/open/floor/plating/ground/mars/random/sand,
/area/mainship/hallways/hangar)
"Yk" = (
/obj/effect/turf_decal/warning_stripes/thin{
	dir = 1
	},
/turf/open/floor/plating/ground/desertdam/asphalt,
/area/mainship/hallways/hangar)

(1,1,1) = {"
Bq
Bq
Bq
Bq
Bq
Bq
Bq
Bq
Bq
Bq
Bq
Bq
Bq
Bq
Bq
Bq
Bq
Bq
Bq
Bq
Bq
Bq
Bq
Bq
Bq
Bq
Bq
Bq
Bq
Bq
Bq
Bq
Bq
Bq
Bq
Bq
Bq
Bq
Bq
Bq
Bq
Bq
Bq
Bq
Bq
Bq
Bq
Bq
Bq
Bq
Bq
Bq
Bq
Bq
Bq
Bq
Bq
Bq
Bq
Bq
Bq
Bq
Bq
Bq
Bq
Bq
Bq
Bq
Bq
Bq
Bq
Bq
Bq
Bq
Bq
Bq
Bq
Bq
Bq
Bq
"}
(2,1,1) = {"
Bq
iK
iK
iK
iK
iK
iK
iK
iK
iK
iK
iK
iK
iK
iK
iK
iK
iK
iK
iK
iK
iK
iK
iK
iK
iK
iK
iK
iK
iK
iK
iK
iK
iK
iK
iK
iK
iK
iK
iK
iK
iK
iK
iK
iK
iK
iK
iK
iK
iK
iK
iK
iK
iK
iK
iK
iK
iK
iK
iK
iK
iK
iK
iK
iK
iK
iK
iK
iK
iK
iK
iK
iK
iK
iK
iK
iK
iK
iK
Bq
"}
(3,1,1) = {"
Bq
iK
iK
iK
iK
iK
iK
iK
iK
iK
iK
iK
iK
iK
iK
iK
iK
iK
iK
iK
iK
iK
iK
iK
iK
iK
iK
iK
iK
iK
iK
iK
iK
iK
iK
iK
iK
iK
iK
iK
iK
iK
iK
iK
iK
iK
iK
iK
iK
iK
iK
iK
iK
iK
iK
iK
iK
iK
iK
iK
iK
iK
iK
iK
iK
iK
iK
iK
iK
iK
iK
iK
iK
iK
iK
iK
iK
iK
iK
Bq
"}
(4,1,1) = {"
Bq
iK
iK
iK
iK
iK
iK
iK
iK
iK
iK
iK
iK
iK
iK
iK
iK
iK
iK
iK
iK
iK
iK
iK
iK
iK
iK
iK
iK
iK
iK
iK
iK
iK
iK
iK
iK
iK
iK
iK
iK
iK
sf
sf
sf
sf
sf
iK
iK
iK
iK
iK
iK
iK
iK
sf
sf
iK
iK
iK
iK
iK
sf
sf
sf
iK
iK
iK
sf
Dm
sf
iK
iK
iK
iK
iK
iK
iK
iK
Bq
"}
(5,1,1) = {"
Bq
iK
iK
iK
iK
iK
iK
iK
iK
iK
iK
iK
iK
iK
iK
iK
iK
iK
iK
iK
iK
iK
iK
iK
iK
iK
iK
iK
iK
iK
iK
iK
iK
iK
sf
sf
sf
sf
sf
sf
sf
sf
sf
sf
sf
sf
sf
sf
iK
iK
iK
iK
sf
sf
sf
sf
sf
sf
sf
sf
sf
sf
sf
sf
sf
sf
sf
sf
sf
sf
sf
iK
iK
iK
iK
iK
iK
iK
iK
Bq
"}
(6,1,1) = {"
Bq
iK
iK
iK
iK
iK
iK
sf
sf
sf
iK
iK
iK
iK
iK
iK
iK
iK
iK
iK
iK
iK
iK
iK
iK
iK
sf
iK
iK
iK
iK
iK
sf
sf
sf
sf
sf
sf
sf
sf
sf
sf
sf
sf
sf
sf
sf
sf
sf
iK
iK
sf
sf
sf
sf
sf
sf
sf
sf
sf
sf
sf
sf
sf
sf
sf
sf
sf
sf
sf
sf
sf
sf
sf
iK
iK
iK
iK
iK
Bq
"}
(7,1,1) = {"
Bq
iK
iK
iK
sf
sf
sf
sf
sf
sf
sf
sf
iK
iK
iK
iK
iK
iK
iK
iK
iK
iK
iK
iK
sf
sf
sf
sf
iK
iK
iK
sf
sf
sf
sf
sf
sf
sf
sf
sf
sf
sf
sf
sf
sf
sf
sf
sf
sf
sf
sf
sf
sf
sf
sf
sf
sf
sf
sf
sf
sf
sf
sf
sf
sf
VV
VV
VV
VV
VV
VV
VV
VV
VV
VV
sf
iK
iK
iK
Bq
"}
(8,1,1) = {"
Bq
iK
iK
sf
sf
sf
sf
sf
sf
sf
sf
sf
sf
sf
sf
sf
sf
iK
iK
iK
sf
sf
sf
sf
sf
sf
sf
sf
sf
sf
sf
sf
sf
sf
sf
sf
sf
sf
sf
sf
sf
sf
sf
sf
sf
sf
sf
sf
sf
sf
sf
sf
sf
sf
sf
sf
sf
sf
sf
sf
sf
sf
sf
sf
sf
VV
VV
VV
VV
VV
VV
VV
VV
VV
VV
sf
sf
iK
iK
Bq
"}
(9,1,1) = {"
Bq
iK
iK
sf
sf
sf
sf
sf
sf
sf
sf
sf
sf
sf
sf
sf
sf
sf
sf
sf
sf
sf
sf
sf
sf
sf
sf
sf
sf
sf
sf
sf
sf
sf
sf
sf
sf
sf
sf
sf
sf
sf
sf
sf
sf
sf
sf
sf
sf
sf
sf
sf
sf
sf
sf
sf
sf
sf
sf
sf
sf
sf
sf
sf
sf
VV
VV
VV
VV
VV
VV
VV
VV
VV
VV
sf
sf
iK
iK
Bq
"}
(10,1,1) = {"
Bq
iK
sf
sf
sf
sf
sf
sf
sf
sf
sf
sf
sf
sf
sf
sf
sf
sf
sf
sf
sf
sf
sf
sf
sf
sf
sf
sf
sf
sf
sf
sf
sf
sf
sf
sf
sf
sf
sf
sf
sf
sf
sf
sf
sf
sf
sf
sf
sf
sf
sf
sf
sf
sf
sf
sf
sf
sf
sf
sf
sf
sf
sf
sf
sf
VV
VV
VV
VV
VV
VV
VV
VV
VV
VV
sf
sf
sf
iK
Bq
"}
(11,1,1) = {"
Bq
iK
sf
sf
sf
sf
sf
sf
sf
sf
sf
sf
sf
sf
sf
sf
sf
sf
sf
sf
sf
sf
sf
sf
sf
sf
sf
sf
sf
sf
sf
sf
sf
sf
sf
sf
sf
sf
sf
sf
sf
sf
sf
sf
sf
sf
sf
sf
sf
sf
sf
sf
sf
sf
sf
sf
sf
sf
sf
sf
sf
sf
sf
sf
sf
VV
VV
VV
VV
VV
VV
VV
VV
VV
VV
sf
sf
sf
iK
Bq
"}
(12,1,1) = {"
Bq
iK
sf
sf
sf
sf
sf
sf
zL
sf
sf
sf
sf
sf
sf
sf
sf
sf
sf
sf
sf
sf
sf
sf
sf
sf
sf
sf
sf
sf
sf
sf
sf
sf
sf
sf
sf
sf
sf
sf
sf
sf
sf
sf
sf
sf
sf
sf
sf
sf
sf
sf
sf
sf
sf
sf
sf
sf
sf
sf
sf
sf
sf
sf
sf
VV
VV
VV
VV
VV
VV
VV
VV
VV
VV
Uk
sf
sf
iK
Bq
"}
(13,1,1) = {"
Bq
iK
sf
sf
sf
sf
sf
sf
sf
sf
sf
sf
sf
sf
sf
sf
sf
sf
sf
sf
sf
sf
sf
sf
sf
sf
sf
sf
sf
sf
sf
sf
sf
sf
sf
sf
sf
sf
sf
sf
sf
sf
sf
sf
sf
sf
sf
sf
sf
sf
sf
sf
sf
sf
sf
sf
sf
sf
sf
sf
sf
sf
sf
sf
sf
VV
VV
VV
VV
VV
VV
VV
VV
VV
VV
sf
sf
sf
iK
Bq
"}
(14,1,1) = {"
Bq
iK
iK
sf
sf
sf
sf
sf
Uk
sf
sf
sf
sf
sf
sf
sf
iK
iK
iK
iK
iK
iK
iK
sf
sf
sf
sf
sf
sf
sf
sf
sf
sf
sf
sf
sf
sf
sf
sf
sf
sf
sf
sf
sf
sf
sf
sf
sf
sf
sf
sf
sf
sf
sf
sf
sf
sf
sf
sf
sf
sf
sf
sf
sf
sf
VV
VV
VV
VV
VV
VV
VV
VV
VV
VV
sf
sf
sf
iK
Bq
"}
(15,1,1) = {"
Bq
iK
iK
iK
sf
sf
sf
sf
sf
sf
sf
sf
sf
sf
iK
iK
iK
iK
iK
iK
iK
iK
iK
iK
sf
sf
sf
sf
sf
sf
sf
sf
sf
sf
sf
sf
sf
sf
sf
sf
sf
sf
sf
sf
sf
sf
sf
sf
sf
sf
sf
sf
sf
sf
sf
sf
sf
sf
sf
sf
sf
sf
sf
sf
sf
sf
sf
sf
sf
sf
sf
sf
sf
sf
sf
sf
sf
sf
cj
Bq
"}
(16,1,1) = {"
Bq
iK
iK
iK
sf
sf
sf
sf
sf
sf
sf
sf
sf
iK
iK
iK
iK
iK
iK
iK
iK
iK
iK
iK
iK
iK
sf
sf
sf
sf
sf
sf
iK
iK
iK
sf
sf
sf
sf
sf
sf
sf
sf
sf
sf
sf
sf
sf
sf
sf
sf
sf
sf
sf
sf
sf
sf
sf
sf
sf
mk
nJ
nJ
nJ
nJ
nJ
nJ
nJ
nJ
nJ
nJ
nJ
nJ
nJ
nJ
nJ
nJ
nJ
xe
Qc
"}
(17,1,1) = {"
Bq
iK
iK
iK
sf
sf
sf
sf
sf
sf
sf
sf
iK
iK
iK
iK
iK
iK
iK
iK
iK
iK
iK
iK
iK
iK
iK
iK
iK
iK
sf
iK
iK
iK
iK
sf
sf
sf
sf
sf
sf
sf
sf
sf
sf
sf
sf
sf
sf
sf
sf
sf
sf
sf
sf
sf
sf
sf
sf
sf
vn
zo
zo
lg
zo
zo
lg
zo
zo
lg
zo
zo
lg
zo
zo
lg
zo
zo
Uh
jH
"}
(18,1,1) = {"
Bq
iK
iK
cj
VV
VV
VV
VV
VV
VV
VV
VV
iK
iK
iK
iK
iK
iK
iK
iK
iK
iK
iK
iK
iK
iK
iK
iK
iK
iK
iK
iK
iK
iK
iK
iK
sf
sf
sf
sf
sf
sf
sf
sf
sf
sf
sf
sf
sf
sf
sf
sf
sf
sf
sf
sf
sf
sf
sf
sf
vn
zo
zo
vR
zo
zo
vR
zo
zo
vR
zo
zo
vR
zo
zo
vR
zo
zo
Uh
jH
"}
(19,1,1) = {"
Bq
iK
iK
cj
VV
VV
VV
VV
VV
VV
VV
VV
iK
iK
iK
iK
iK
iK
iK
iK
iK
iK
iK
iK
iK
iK
iK
iK
iK
iK
iK
iK
iK
iK
iK
iK
sf
sf
sf
sf
sf
sf
sf
sf
sf
sf
sf
sf
sf
sf
sf
sf
sf
sf
sf
sf
sf
sf
sf
sf
vn
zo
zo
FY
Qf
Qf
Qf
Qf
Qf
Qf
Qf
Qf
Qf
Qf
Qf
Qf
Qf
Qf
Gw
iN
"}
(20,1,1) = {"
Bq
iK
iK
cj
VV
VV
VV
VV
VV
VV
VV
VV
VV
iK
iK
iK
iK
iK
iK
iK
iK
iK
iK
iK
iK
iK
iK
iK
iK
iK
iK
iK
iK
iK
iK
iK
sf
sf
sf
sf
sf
sf
sf
sf
sf
sf
sf
sf
sf
sf
sf
sf
sf
sf
sf
sf
sf
sf
sf
sf
vn
ro
Yk
lJ
sf
sf
sf
sf
sf
sf
sf
sf
sf
sf
sf
sf
sf
sf
cj
Bq
"}
(21,1,1) = {"
Bq
iK
iK
cj
VV
VV
Vr
VV
VV
VV
VV
VV
VV
VV
iK
iK
iK
iK
iK
iK
iK
iK
iK
iK
iK
iK
iK
iK
iK
iK
iK
iK
iK
iK
iK
sf
sf
sf
sf
sf
sf
sf
sf
sf
sf
sf
sf
sf
sf
sf
sf
sf
sf
sf
sf
sf
sf
sf
sf
sf
vn
zo
zo
lJ
sf
sf
sf
sf
sf
sf
sf
sf
sf
sf
sf
sf
sf
iK
iK
Bq
"}
(22,1,1) = {"
Bq
iK
iK
cj
VV
VV
VV
VV
VV
VV
VV
VV
VV
VV
VV
iK
iK
iK
iK
iK
iK
iK
iK
iK
iK
iK
iK
iK
iK
iK
iK
iK
iK
iK
sf
sf
sf
sf
sf
sf
sf
sf
sf
sf
sf
sf
sf
sf
sf
sf
sf
sf
sf
sf
sf
sf
sf
sf
sf
sf
vn
zo
zo
lJ
sf
sf
sf
sf
sf
sf
sf
sf
sf
sf
sf
sf
iK
iK
iK
Bq
"}
(23,1,1) = {"
Bq
iK
iK
cj
VV
VV
VV
VV
VV
Ar
VV
VV
VV
VV
VV
iK
iK
iK
iK
iK
iK
iK
iK
iK
iK
iK
iK
iK
iK
iK
iK
iK
iK
sf
sf
sf
sf
sf
sf
sf
sf
sf
sf
sf
sf
sf
sf
sf
sf
sf
sf
sf
sf
sf
sf
sf
sf
sf
sf
sf
vn
ro
Yk
lJ
sf
sf
sf
sf
sf
sf
sf
sf
sf
sf
sf
sf
iK
iK
iK
Bq
"}
(24,1,1) = {"
Bq
iK
iK
cj
VV
VV
Vr
VV
VV
VV
VV
VV
VV
VV
VV
iK
iK
iK
iK
iK
iK
iK
iK
iK
iK
iK
iK
iK
iK
iK
iK
iK
sf
sf
sf
sf
sf
sf
sf
sf
sf
sf
sf
sf
sf
sf
sf
sf
sf
sf
sf
sf
sf
sf
sf
sf
sf
sf
sf
sf
vn
zo
zo
lJ
sf
sf
sf
sf
sf
sf
sf
sf
sf
sf
sf
sf
iK
iK
iK
Bq
"}
(25,1,1) = {"
Bq
iK
iK
cj
VV
VV
VV
VV
VV
VV
VV
VV
VV
VV
VV
iK
iK
iK
iK
iK
iK
iK
iK
iK
iK
iK
iK
iK
iK
iK
iK
iK
sf
sf
sf
sf
sf
sf
sf
sf
sf
sf
sf
sf
sf
sf
sf
sf
sf
sf
sf
sf
sf
sf
sf
sf
sf
sf
sf
sf
vn
zo
zo
lJ
sf
sf
sf
sf
sf
sf
sf
sf
sf
sf
sf
sf
sf
iK
iK
Bq
"}
(26,1,1) = {"
Bq
iK
iK
cj
VV
VV
VV
VV
VV
VV
VV
VV
VV
VV
VV
iK
iK
iK
iK
iK
iK
iK
iK
iK
iK
iK
iK
iK
iK
iK
iK
sf
sf
sf
sf
sf
sf
sf
sf
sf
sf
sf
sf
sf
sf
sf
sf
sf
sf
sf
sf
sf
sf
sf
sf
sf
sf
sf
sf
sf
vn
ro
Yk
lJ
sf
sf
sf
sf
sf
sf
sf
sf
sf
sf
sf
sf
sf
iK
iK
Bq
"}
(27,1,1) = {"
Bq
iK
iK
cj
VV
VV
Vr
VV
VV
VV
VV
VV
VV
VV
VV
iK
iK
iK
iK
iK
iK
iK
iK
iK
iK
iK
iK
iK
iK
iK
iK
sf
sf
sf
sf
sf
sf
sf
sf
sf
sf
sf
sf
sf
sf
sf
sf
sf
sf
sf
sf
sf
sf
sf
sf
sf
sf
sf
sf
sf
vn
zo
zo
lJ
sf
sf
sf
sf
sf
sf
sf
sf
sf
sf
sf
sf
sf
sf
iK
Bq
"}
(28,1,1) = {"
Bq
iK
iK
cj
hr
VV
VV
VV
tH
Lu
VV
VV
VV
VV
la
iK
iK
iK
iK
iK
iK
iK
iK
iK
iK
iK
iK
iK
iK
iK
sf
sf
sf
sf
sf
sf
sf
sf
sf
sf
sf
sf
sf
sf
sf
sf
sf
sf
sf
sf
sf
sf
sf
sf
sf
sf
sf
sf
sf
sf
vn
zo
zo
lJ
sf
sf
sf
sf
sf
sf
sf
sf
sf
sf
sf
sf
sf
sf
iK
Bq
"}
(29,1,1) = {"
Bq
iK
iK
cj
VV
kQ
xr
VV
VV
VV
VV
VV
VV
VV
iK
iK
iK
iK
iK
iK
iK
iK
iK
iK
iK
iK
iK
iK
sf
sf
sf
sf
sf
sf
sf
sf
sf
sf
sf
sf
sf
sf
sf
sf
sf
sf
sf
sf
sf
sf
sf
sf
sf
sf
sf
sf
sf
sf
sf
sf
vn
ro
Yk
lJ
sf
sf
sf
sf
sf
sf
sf
sf
sf
sf
sf
sf
sf
sf
iK
Bq
"}
(30,1,1) = {"
Bq
iK
iK
cj
VV
pq
Mt
VV
VV
VV
VV
VV
VV
VV
iK
iK
iK
iK
iK
iK
iK
iK
iK
iK
iK
iK
iK
sf
sf
sf
sf
sf
sf
sf
sf
sf
sf
sf
sf
sf
sf
sf
sf
sf
sf
sf
sf
sf
sf
sf
sf
sf
sf
sf
sf
sf
sf
sf
sf
sf
vn
zo
zo
lJ
sf
sf
sf
sf
sf
sf
sf
sf
sf
sf
sf
sf
sf
sf
iK
Bq
"}
(31,1,1) = {"
Bq
iK
iK
cj
VV
kQ
xr
VV
VV
VV
VV
VV
VV
VV
iK
iK
iK
iK
iK
iK
iK
iK
iK
iK
iK
iK
sf
sf
sf
sf
sf
sf
sf
sf
sf
sf
sf
sf
sf
sf
sf
sf
sf
sf
sf
sf
sf
sf
sf
sf
sf
sf
sf
sf
sf
sf
sf
sf
sf
sf
vn
zo
zo
lJ
sf
sf
sf
sf
sf
sf
sf
sf
sf
sf
sf
sf
sf
sf
iK
Bq
"}
(32,1,1) = {"
Bq
iK
iK
cj
VV
pq
Mt
VV
VV
aR
VV
VV
VV
VV
VV
iK
iK
iK
iK
iK
iK
iK
iK
iK
iK
sf
sf
sf
sf
sf
sf
sf
sf
sf
sf
sf
sf
sf
sf
sf
sf
sf
sf
sf
sf
sf
sf
sf
sf
sf
sf
sf
sf
sf
sf
sf
sf
sf
sf
sf
vn
ro
Yk
lJ
sf
sf
sf
sf
sf
sf
sf
sf
sf
sf
sf
sf
sf
sf
iK
Bq
"}
(33,1,1) = {"
Bq
iK
iK
cj
VV
kQ
xr
VV
VV
VV
VV
VV
VV
VV
VV
iK
iK
iK
iK
iK
iK
iK
iK
iK
nJ
nJ
nJ
nJ
nJ
nJ
nJ
nJ
nJ
nJ
nJ
nJ
nJ
nJ
nJ
nJ
nJ
nJ
nJ
nJ
nJ
nJ
nJ
nJ
nJ
nJ
nJ
nJ
nJ
nJ
nJ
nJ
nJ
nJ
nJ
nJ
lb
zo
zo
lJ
sf
sf
sf
sf
sf
sf
sf
sf
sf
sf
sf
sf
sf
sf
iK
Bq
"}
(34,1,1) = {"
Bq
iK
iK
cj
VV
pq
Mt
VV
VV
VV
VV
VV
VV
VV
VV
iK
iK
iK
iK
iK
iK
iK
iK
iK
lg
zo
zo
lg
zo
zo
lg
zo
zo
lg
zo
zo
lg
zo
zo
lg
zo
zo
lg
zo
zo
lg
zo
zo
lg
zo
zo
lg
zo
zo
zo
lg
zo
zo
lg
zo
zo
lg
zo
lJ
sf
sf
sf
sf
sf
sf
sf
sf
sf
sf
sf
sf
sf
sf
sf
Bq
"}
(35,1,1) = {"
Bq
iK
iK
cj
VV
kQ
xr
VV
VV
VV
VV
VV
VV
VV
VV
iK
iK
iK
iK
iK
iK
iK
iK
iK
vR
zo
zo
vR
zo
zo
vR
zo
zo
vR
zo
zo
vR
zo
zo
vR
zo
zo
vR
zo
zo
vR
zo
zo
vR
zo
zo
vR
zo
zo
zo
vR
zo
zo
vR
zo
zo
vR
zo
lJ
sf
sf
sf
sf
sf
sf
sf
sf
sf
sf
sf
sf
sf
sf
sf
Bq
"}
(36,1,1) = {"
Bq
iK
iK
cj
VV
VV
VV
VV
VV
VV
VV
VV
VV
VV
VV
cj
iK
iK
iK
iK
iK
iK
iK
iK
Qf
Qf
Qf
Qf
Qf
Qf
Qf
Qf
Qf
Qf
Qf
Qf
Qf
Qf
Qf
Qf
Qf
Qf
Qf
Qf
Qf
Qf
Qf
OV
zo
zo
FY
Qf
Qf
Qf
Qf
Qf
Qf
Qf
Qf
Qf
Qf
Qf
Qf
Pl
sf
sf
sf
sf
sf
sf
sf
sf
sf
sf
sf
sf
sf
sf
iK
Bq
"}
(37,1,1) = {"
Bq
iK
iK
cj
VV
VV
VV
VV
VV
VV
VV
VV
VV
VV
VV
cj
iK
iK
iK
iK
iK
iK
iK
iK
sf
sf
sf
sf
sf
sf
sf
sf
sf
sf
sf
sf
sf
sf
sf
sf
sf
sf
sf
sf
sf
sf
sf
vn
ro
Yk
lJ
sf
sf
sf
sf
sf
sf
sf
sf
sf
sf
sf
sf
sf
sf
sf
sf
sf
sf
sf
sf
sf
sf
sf
sf
sf
sf
iK
iK
Bq
"}
(38,1,1) = {"
Bq
iK
iK
cj
VV
VV
VV
VV
VV
VV
VV
VV
VV
VV
VV
iK
iK
iK
iK
iK
iK
iK
iK
iK
iK
iK
sf
sf
sf
sf
sf
sf
sf
sf
sf
sf
sf
sf
sf
sf
sf
sf
sf
sf
sf
sf
sf
vn
zo
zo
lJ
sf
sf
sf
sf
sf
sf
sf
sf
sf
sf
sf
sf
sf
sf
sf
sf
sf
sf
sf
sf
sf
sf
sf
sf
sf
sf
iK
iK
Bq
"}
(39,1,1) = {"
Bq
iK
iK
iK
iK
sf
sf
sf
sf
sf
sf
sf
sf
sf
sf
iK
iK
iK
iK
iK
iK
iK
iK
iK
iK
iK
iK
sf
sf
sf
sf
sf
sf
sf
sf
sf
sf
sf
sf
sf
sf
sf
sf
sf
sf
sf
sf
vn
zo
zo
lJ
sf
sf
sf
sf
sf
sf
sf
sf
sf
sf
sf
sf
sf
sf
sf
sf
sf
sf
sf
sf
sf
sf
sf
sf
sf
sf
iK
iK
Bq
"}
(40,1,1) = {"
Bq
iK
iK
iK
iK
sf
sf
sf
sf
sf
sf
sf
sf
sf
iK
iK
iK
iK
iK
iK
iK
iK
iK
iK
iK
iK
iK
sf
sf
sf
sf
sf
sf
sf
sf
sf
sf
sf
sf
sf
sf
sf
sf
sf
sf
sf
sf
vn
ro
Yk
lJ
sf
sf
sf
sf
sf
sf
sf
sf
sf
sf
sf
sf
sf
sf
sf
sf
sf
sf
sf
sf
sf
sf
sf
sf
sf
sf
iK
iK
Bq
"}
(41,1,1) = {"
Bq
iK
iK
iK
iK
sf
sf
sf
sf
sf
sf
sf
sf
sf
iK
iK
iK
iK
iK
iK
iK
iK
iK
iK
iK
iK
iK
sf
sf
sf
sf
sf
sf
sf
sf
sf
sf
sf
sf
sf
sf
sf
sf
sf
sf
sf
sf
vn
zo
zo
lJ
sf
sf
sf
sf
sf
sf
sf
sf
sf
sf
sf
sf
sf
sf
sf
sf
sf
sf
sf
sf
sf
sf
sf
sf
sf
sf
iK
iK
Bq
"}
(42,1,1) = {"
Bq
iK
iK
iK
iK
sf
sf
sf
sf
sf
sf
sf
sf
sf
iK
iK
iK
iK
iK
iK
iK
iK
iK
iK
iK
iK
iK
sf
sf
sf
sf
sf
sf
sf
sf
sf
sf
sf
sf
sf
sf
sf
sf
sf
sf
sf
sf
vn
zo
zo
lJ
sf
sf
sf
sf
sf
sf
sf
sf
sf
sf
sf
sf
sf
sf
sf
sf
sf
sf
sf
sf
sf
sf
sf
sf
sf
sf
iK
iK
Bq
"}
(43,1,1) = {"
Bq
iK
iK
iK
iK
sf
sf
sf
sf
sf
sf
sf
sf
iK
iK
iK
iK
iK
iK
iK
iK
iK
iK
iK
iK
iK
sf
sf
sf
sf
sf
sf
sf
sf
sf
sf
sf
sf
sf
sf
sf
sf
sf
sf
sf
sf
sf
vn
ro
Yk
lJ
sf
sf
sf
rc
rc
rc
rc
rc
rc
rc
rc
rc
rc
rc
rc
rc
rc
rc
rc
rc
rc
rc
rc
rc
sf
sf
iK
iK
Bq
"}
(44,1,1) = {"
Bq
iK
iK
iK
sf
sf
sf
sf
sf
sf
sf
sf
sf
iK
iK
iK
iK
iK
iK
iK
iK
iK
iK
iK
iK
sf
sf
sf
sf
sf
sf
sf
sf
sf
sf
sf
sf
sf
sf
sf
sf
sf
sf
sf
mk
nJ
nJ
lb
zo
zo
lJ
sf
sf
Tx
Kc
Kc
Kc
Kc
Kc
Kc
Kc
Kc
Kc
Kc
Kc
Kc
Kc
Kc
Kc
Kc
Kc
Kc
Kc
Kc
Kc
VI
sf
iK
iK
Bq
"}
(45,1,1) = {"
Bq
iK
iK
iK
iK
sf
sf
sf
sf
sf
sf
sf
sf
sf
iK
iK
iK
iK
iK
iK
iK
iK
iK
iK
sf
sf
sf
sf
sf
sf
sf
sf
sf
sf
sf
sf
sf
sf
sf
sf
sf
sf
sf
sf
vn
zo
zo
FT
zo
zo
lJ
sf
sf
Tx
Kc
Kc
Kc
Kc
Kc
Kc
Kc
Kc
Kc
Kc
Kc
Kc
Kc
Kc
Kc
Kc
Kc
Kc
Kc
Kc
Kc
VI
sf
sf
iK
Bq
"}
(46,1,1) = {"
Bq
iK
iK
iK
iK
sf
sf
sf
sf
sf
sf
sf
sf
sf
sf
sf
sf
iK
iK
iK
iK
iK
iK
sf
sf
sf
sf
sf
sf
sf
sf
sf
sf
sf
sf
sf
sf
sf
sf
sf
sf
sf
sf
sf
vn
JM
zo
FT
ro
Yk
lJ
sf
sf
Tx
Kc
Kc
Kc
Kc
Kc
Kc
Kc
Kc
Kc
Kc
Kc
Kc
Kc
Kc
Kc
Kc
Kc
Kc
Kc
Kc
Kc
VI
sf
sf
iK
Bq
"}
(47,1,1) = {"
Bq
iK
iK
iK
sf
sf
sf
sf
sf
sf
sf
sf
sf
sf
sf
sf
sf
sf
sf
sf
sf
sf
sf
sf
sf
sf
sf
sf
sf
sf
sf
sf
sf
sf
sf
sf
sf
sf
sf
sf
sf
sf
sf
sf
vn
zo
zo
FT
zo
zo
lJ
sf
sf
Tx
Kc
Kc
Kc
Kc
Kc
Kc
Kc
Kc
Kc
Kc
Kc
Kc
Kc
Kc
Kc
Kc
Kc
Kc
Kc
Kc
Kc
VI
sf
sf
iK
Bq
"}
(48,1,1) = {"
Bq
iK
iK
sf
sf
sf
sf
sf
Uk
sf
sf
sf
sf
sf
sf
sf
sf
sf
sf
sf
sf
sf
sf
sf
sf
sf
sf
sf
sf
sf
sf
sf
sf
sf
sf
sf
sf
sf
sf
sf
sf
sf
sf
sf
vn
zo
zo
FT
zo
zo
lJ
sf
sf
Tx
Kc
Kc
Kc
Kc
Kc
Kc
Kc
Kc
Kc
Kc
Kc
Kc
Kc
Kc
Kc
Kc
Kc
Kc
Kc
Kc
Kc
VI
sf
iK
iK
Bq
"}
(49,1,1) = {"
Bq
iK
iK
sf
sf
sf
sf
sf
sf
sf
sf
sf
sf
sf
sf
sf
sf
sf
sf
sf
sf
sf
sf
sf
sf
sf
sf
sf
sf
sf
sf
sf
sf
sf
sf
sf
sf
sf
sf
sf
sf
sf
sf
sf
vn
zo
zo
FT
ro
Yk
lJ
sf
sf
Tx
Kc
Kc
Kc
Kc
Kc
Kc
Kc
Kc
Kc
Kc
rz
Kc
Kc
Kc
Kc
Kc
Kc
Kc
Kc
Kc
Kc
VI
sf
iK
iK
Bq
"}
(50,1,1) = {"
Bq
iK
iK
sf
sf
sf
sf
sf
ec
sf
sf
sf
sf
sf
sf
sf
sf
sf
sf
sf
sf
sf
sf
sf
sf
sf
sf
sf
sf
sf
sf
sf
sf
sf
sf
sf
sf
sf
sf
sf
sf
sf
sf
sf
os
Qf
Qf
OV
zo
zo
lJ
sf
sf
Tx
Kc
Kc
Kc
Kc
Kc
Kc
Kc
Kc
Kc
Kc
Kc
Kc
Kc
Kc
Kc
Kc
Kc
Kc
Kc
Kc
Kc
VI
sf
iK
iK
Bq
"}
(51,1,1) = {"
Bq
iK
iK
sf
sf
sf
sf
sf
sf
sf
sf
sf
sf
sf
sf
sf
sf
sf
sf
sf
sf
sf
sf
sf
sf
sf
sf
sf
sf
sf
sf
sf
sf
sf
sf
sf
sf
sf
sf
sf
sf
sf
sf
sf
sf
sf
sf
vn
zo
zo
lJ
sf
sf
Tx
Kc
Kc
Kc
Kc
Kc
Kc
Kc
Kc
Kc
Kc
Kc
Kc
Kc
Kc
Kc
Kc
Kc
Kc
Kc
Kc
Kc
VI
sf
iK
iK
Bq
"}
(52,1,1) = {"
Bq
iK
iK
iK
sf
sf
sf
sf
sf
sf
sf
sf
sf
sf
sf
sf
iK
sf
sf
sf
sf
sf
sf
sf
sf
sf
sf
sf
sf
sf
sf
sf
sf
sf
sf
sf
sf
sf
sf
sf
sf
sf
sf
sf
sf
sf
sf
vn
ro
Yk
lJ
sf
sf
Tx
Kc
Kc
Kc
Kc
Kc
Kc
Kc
Kc
Kc
Kc
Kc
Kc
Kc
Kc
Kc
Kc
Kc
Kc
Kc
Kc
Kc
VI
sf
iK
iK
Bq
"}
(53,1,1) = {"
Bq
iK
iK
iK
sf
sf
sf
sf
sf
sf
sf
sf
sf
sf
iK
iK
iK
iK
iK
iK
sf
sf
iK
iK
iK
iK
sf
sf
sf
sf
sf
sf
sf
sf
sf
sf
sf
sf
sf
sf
sf
sf
sf
sf
sf
sf
sf
vn
zo
zo
lJ
sf
sf
Tx
Kc
Kc
Kc
Kc
Kc
Kc
Kc
Kc
Kc
Kc
Kc
Kc
Kc
Kc
Kc
Kc
Kc
Kc
Kc
Kc
Kc
VI
sf
sf
iK
Bq
"}
(54,1,1) = {"
Bq
iK
iK
iK
sf
sf
sf
sf
sf
sf
sf
sf
sf
sf
iK
iK
iK
iK
iK
iK
iK
iK
iK
iK
iK
iK
iK
sf
sf
sf
sf
sf
sf
sf
sf
sf
sf
sf
sf
sf
sf
sf
sf
sf
sf
sf
sf
vn
zo
zo
lJ
sf
sf
Tx
Kc
Kc
Kc
Kc
Kc
Kc
Kc
Kc
Kc
Kc
Kc
Kc
Kc
Kc
Kc
Kc
Kc
Kc
Kc
Kc
Kc
VI
sf
sf
iK
Bq
"}
(55,1,1) = {"
Bq
iK
iK
iK
iK
sf
sf
sf
sf
sf
sf
sf
iK
iK
iK
iK
iK
iK
iK
iK
iK
iK
iK
iK
iK
iK
iK
iK
iK
iK
sf
sf
sf
sf
sf
sf
sf
sf
sf
sf
sf
sf
sf
sf
sf
sf
sf
vn
ro
Yk
lJ
sf
sf
sf
VE
VE
VE
VE
VE
VE
VE
VE
VE
VE
VE
VE
VE
VE
VE
VE
VE
VE
VE
VE
VE
sf
sf
iK
iK
Bq
"}
(56,1,1) = {"
Bq
iK
iK
iK
iK
iK
sf
sf
sf
sf
sf
iK
iK
iK
iK
iK
iK
iK
iK
iK
iK
iK
iK
iK
iK
iK
iK
iK
iK
iK
iK
iK
iK
iK
iK
iK
iK
iK
sf
sf
sf
sf
sf
sf
sf
sf
sf
vn
zo
zo
lJ
sf
sf
sf
sf
sf
sf
sf
sf
sf
sf
sf
sf
sf
sf
sf
sf
sf
sf
sf
sf
sf
sf
sf
sf
sf
sf
iK
iK
Bq
"}
(57,1,1) = {"
Bq
iK
iK
iK
iK
iK
iK
sf
sf
sf
iK
iK
iK
iK
iK
iK
iK
iK
iK
iK
iK
iK
iK
iK
iK
iK
iK
iK
iK
iK
iK
iK
iK
iK
iK
iK
iK
iK
iK
iK
iK
sf
sf
sf
sf
sf
sf
vn
zo
zo
lJ
sf
sf
sf
sf
sf
sf
sf
Xb
sf
sf
sf
sf
sf
sf
sf
sf
sf
sf
Xb
sf
sf
sf
sf
iK
iK
iK
iK
iK
Bq
"}
(58,1,1) = {"
Bq
iK
iK
iK
iK
iK
iK
iK
iK
iK
iK
iK
iK
iK
iK
iK
iK
iK
iK
iK
iK
iK
iK
iK
iK
iK
iK
iK
iK
iK
iK
iK
iK
iK
iK
iK
iK
iK
iK
iK
iK
iK
iK
sf
sf
sf
sf
vn
ro
Yk
lJ
sf
sf
sf
iK
iK
iK
iK
iK
iK
iK
iK
iK
iK
iK
iK
iK
sf
iK
iK
sf
iK
iK
iK
iK
iK
iK
iK
iK
Bq
"}
(59,1,1) = {"
Bq
iK
iK
iK
iK
iK
iK
iK
iK
iK
iK
iK
iK
iK
iK
iK
iK
iK
iK
iK
iK
iK
iK
iK
iK
iK
iK
iK
iK
iK
iK
iK
iK
iK
iK
iK
iK
iK
iK
iK
iK
iK
iK
iK
sf
sf
sf
vn
zo
zo
lJ
sf
iK
iK
iK
iK
iK
iK
iK
iK
iK
iK
iK
iK
iK
iK
iK
iK
iK
iK
iK
iK
iK
iK
iK
iK
iK
iK
iK
Bq
"}
(60,1,1) = {"
Bq
Bq
Bq
Bq
Bq
Bq
Bq
Bq
Bq
Bq
Bq
Bq
Bq
Bq
Bq
Bq
Bq
Bq
Bq
Bq
Bq
Bq
Bq
Bq
Bq
Bq
Bq
Bq
Bq
Bq
Bq
Bq
Bq
Bq
Bq
Bq
Bq
Bq
Bq
Bq
Bq
Bq
Bq
Bq
Bq
Bq
cj
Cp
Oz
Oz
mi
cj
Bq
Bq
Bq
Bq
Bq
Bq
Bq
Bq
Bq
Bq
Bq
Bq
Bq
Bq
Bq
Bq
Bq
Bq
Bq
Bq
Bq
Bq
Bq
Bq
Bq
Bq
Bq
Bq
"}
