//MAP CONVERTED BY dmm2tgm.py THIS HEADER COMMENT PREVENTS RECONVERSION, DO NOT REMOVE
"a" = (
/turf/closed/mineral/smooth,
/area/lv624/ground/caves/rock)
"b" = (
/obj/effect/landmark/lv624/fog_blocker/xeno_spawn,
/turf/closed/wall/cult,
/area/lv624/ground/caves/rock)
"c" = (
/obj/effect/landmark/xeno_resin_door,
/obj/effect/landmark/lv624/fog_blocker/xeno_spawn,
/turf/open/floor/plating/ground/dirt,
/area/lv624/ground/caves/west1)
"d" = (
/turf/closed/wall/cult,
/area/lv624/ground/caves/central5)
"e" = (
/obj/effect/landmark/xeno_resin_door,
/turf/open/floor/plating/ground/dirt,
/area/lv624/ground/caves/west1)
"f" = (
/obj/effect/landmark/xeno_resin_door,
/obj/effect/landmark/weed_node,
/obj/effect/landmark/lv624/fog_blocker/xeno_spawn,
/turf/open/floor/plating/ground/dirt,
/area/lv624/ground/caves/west1)
"g" = (
/obj/effect/ai_node,
/obj/effect/landmark/start/job/xenomorph,
/turf/open/floor/plating/ground/dirt,
/area/lv624/ground/caves/west1)
"h" = (
/obj/effect/landmark/weed_node,
/obj/effect/ai_node,
/turf/open/floor/plating/ground/dirt,
/area/lv624/ground/caves/west1)
"i" = (
/obj/effect/landmark/patrol_point{
	id = "TGMC_22";
	name = "TGMC exit point 22"
	},
/turf/open/floor/plating/ground/dirt,
/area/lv624/ground/caves/west1)
"j" = (
/obj/effect/landmark/weed_node,
/turf/open/floor/plating/ground/dirt,
/area/lv624/ground/caves/central5)
"k" = (
/turf/closed/wall/cult,
/area/lv624/ground/caves/rock)
"l" = (
/obj/effect/landmark/patrol_point{
	id = "TGMC_23";
	name = "TGMC exit point 23"
	},
/turf/open/floor/plating/ground/dirt,
/area/lv624/ground/caves/west1)
"m" = (
/obj/effect/landmark/patrol_point{
	id = "TGMC_21";
	name = "TGMC exit point 21"
	},
/turf/open/floor/plating/ground/dirt,
/area/lv624/ground/caves/west1)
"n" = (
/obj/effect/ai_node,
/turf/open/floor/plating/ground/dirt,
/area/lv624/ground/caves/central5)
"q" = (
/obj/effect/landmark/xeno_resin_wall,
/turf/open/floor/plating/ground/dirt,
/area/lv624/ground/caves/central4)
"r" = (
/obj/effect/decal/remains/xeno,
/turf/open/floor/engine/cult{
	dir = 2
	},
/area/lv624/ground/caves/central5)
"t" = (
/obj/effect/landmark/weed_node,
/turf/open/floor/engine/cult{
	dir = 2
	},
/area/lv624/ground/caves/west1)
"u" = (
/turf/open/floor/plating/ground/dirt,
/area/lv624/ground/caves/west1)
"v" = (
/turf/open/floor/plating/ground/dirt,
/area/lv624/ground/caves/central4)
"w" = (
/obj/effect/landmark/weed_node,
/obj/effect/landmark/start/job/xenomorph,
/turf/open/floor/plating/ground/dirt,
/area/lv624/ground/caves/west1)
"z" = (
/obj/effect/ai_node,
/turf/open/floor/plating/ground/dirt,
/area/lv624/ground/caves/west1)
"A" = (
/obj/effect/landmark/lv624/fog_blocker/xeno_spawn,
/turf/open/floor/plating/ground/dirt,
/area/lv624/ground/caves/west1)
"B" = (
/obj/effect/ai_node,
/turf/open/floor/engine/cult{
	dir = 2
	},
/area/lv624/ground/caves/central5)
"C" = (
/obj/effect/landmark/xeno_silo_spawn,
/turf/open/floor/plating/ground/dirt,
/area/lv624/ground/caves/west1)
"E" = (
/turf/open/floor/engine/cult{
	dir = 2
	},
/area/lv624/ground/caves/central5)
"F" = (
/obj/machinery/miner/damaged/platinum,
/turf/open/floor/plating/ground/dirt,
/area/lv624/ground/caves/west1)
"G" = (
/turf/open/floor/engine/cult{
	dir = 2
	},
/area/lv624/ground/caves/west1)
"H" = (
/obj/effect/landmark/xeno_resin_wall,
/turf/open/floor/plating/ground/dirt,
/area/lv624/ground/caves/west1)
"J" = (
/obj/effect/landmark/lv624/fog_blocker/xeno_spawn,
/turf/closed/mineral/smooth/indestructible,
/area/lv624/ground/caves/rock)
"K" = (
/obj/effect/landmark/excavation_site_spawner,
/turf/open/floor/plating/ground/dirt,
/area/lv624/ground/caves/west1)
"L" = (
/obj/effect/landmark/xeno_silo_spawn,
/turf/open/floor/plating/ground/dirt,
/area/lv624/ground/caves/central5)
"M" = (
/obj/effect/landmark/weed_node,
/turf/open/floor/plating/ground/dirt,
/area/lv624/ground/caves/central4)
"N" = (
/obj/effect/landmark/weed_node,
/turf/open/floor/plating/ground/dirt,
/area/lv624/ground/caves/west1)
"O" = (
/obj/effect/landmark/patrol_point{
	id = "TGMC_24";
	name = "TGMC exit point 24"
	},
/turf/open/floor/plating/ground/dirt,
/area/lv624/ground/caves/west1)
"P" = (
/turf/open/floor/plating/ground/dirt,
/area/lv624/ground/caves/central5)
"R" = (
/turf/closed/mineral/smooth/indestructible,
/area/lv624/ground/caves/rock)
"S" = (
/obj/effect/landmark/start/job/xenomorph,
/turf/open/floor/plating/ground/dirt,
/area/lv624/ground/caves/west1)
"V" = (
/obj/effect/landmark/lv624/fog_blocker/xeno_spawn,
/turf/closed/mineral/smooth,
/area/lv624/ground/caves/rock)
"W" = (
/obj/effect/landmark/weed_node,
/obj/effect/landmark/xeno_resin_door,
/turf/open/floor/plating/ground/dirt,
/area/lv624/ground/caves/west1)
"X" = (
/obj/effect/landmark/weed_node,
/turf/open/floor/engine/cult{
	dir = 2
	},
/area/lv624/ground/caves/central5)
"Z" = (
/obj/effect/ai_node,
/turf/open/floor/engine/cult{
	dir = 2
	},
/area/lv624/ground/caves/west1)

(1,1,1) = {"
a
a
a
a
a
a
a
a
a
a
a
a
a
R
a
a
a
a
a
a
a
a
a
a
a
a
a
a
a
a
R
a
a
a
a
a
a
a
a
a
a
a
a
"}
(2,1,1) = {"
a
a
a
a
a
a
a
a
a
a
a
a
a
R
a
a
a
a
a
a
a
a
a
a
a
a
a
a
a
a
R
a
a
a
a
a
a
a
a
a
a
a
a
"}
(3,1,1) = {"
a
a
a
a
a
a
a
a
a
a
a
a
a
R
a
a
a
a
a
a
a
a
a
a
a
a
a
a
a
a
R
a
a
a
a
a
a
a
a
a
a
a
a
"}
(4,1,1) = {"
a
a
a
a
a
a
a
a
a
a
a
a
a
R
a
a
a
a
a
a
a
a
a
a
a
a
a
a
a
a
R
a
a
a
a
a
a
a
a
a
a
a
a
"}
(5,1,1) = {"
a
a
a
R
R
R
R
R
R
R
a
a
a
R
R
R
R
R
R
R
a
a
a
R
R
R
R
R
R
R
R
a
a
R
R
R
R
R
R
R
a
a
a
"}
(6,1,1) = {"
a
a
a
R
R
R
R
R
R
R
a
a
a
R
R
R
R
R
R
R
a
a
a
R
R
R
R
R
R
R
R
a
a
R
R
R
R
R
R
R
a
a
a
"}
(7,1,1) = {"
a
a
a
R
R
R
R
R
R
R
a
a
a
R
R
R
R
R
R
R
a
a
a
R
R
R
R
R
R
R
R
a
a
R
R
R
R
R
R
R
a
a
a
"}
(8,1,1) = {"
a
a
a
R
R
R
R
R
R
R
a
a
a
R
R
R
R
R
R
R
a
a
a
R
R
R
R
R
R
R
R
a
a
R
R
R
R
R
R
R
a
a
a
"}
(9,1,1) = {"
a
a
a
R
R
R
R
R
R
R
a
a
a
R
R
R
R
R
R
R
a
a
a
R
R
R
R
R
R
R
R
a
a
R
R
R
R
R
R
R
a
a
a
"}
(10,1,1) = {"
a
a
a
a
a
a
a
a
a
a
a
a
a
R
a
a
a
a
a
a
a
a
a
a
a
a
a
a
a
a
R
a
a
a
a
a
a
a
a
a
a
a
a
"}
(11,1,1) = {"
a
a
a
a
a
a
a
a
a
a
a
a
a
R
a
a
a
a
a
a
a
a
a
a
a
a
a
a
a
a
u
a
a
a
a
a
a
a
a
a
a
a
a
"}
(12,1,1) = {"
a
a
a
a
a
a
a
a
a
a
a
a
a
H
H
H
H
H
H
a
a
a
a
a
a
a
a
a
a
u
z
u
a
a
a
a
a
a
a
a
a
a
a
"}
(13,1,1) = {"
a
a
a
a
a
a
a
a
a
a
a
H
H
H
u
u
u
u
H
H
H
a
a
a
a
a
a
a
u
N
u
u
a
a
a
a
a
a
a
a
a
a
a
"}
(14,1,1) = {"
a
a
a
a
a
a
a
a
a
a
u
u
u
u
u
u
u
u
u
u
e
u
a
a
a
a
a
a
u
u
u
u
a
a
a
a
a
a
a
a
a
a
a
"}
(15,1,1) = {"
a
a
a
a
a
a
a
a
N
u
u
u
u
H
H
N
u
u
u
u
e
u
k
a
k
u
u
u
N
u
u
u
u
a
a
H
H
H
H
a
a
a
a
"}
(16,1,1) = {"
a
a
a
a
a
a
a
a
u
u
u
u
N
H
H
u
u
u
u
N
e
u
N
u
u
N
u
u
H
H
u
u
u
a
u
u
u
u
H
H
a
a
a
"}
(17,1,1) = {"
a
a
a
a
a
a
a
u
u
u
u
z
u
u
u
u
u
z
u
u
W
u
u
u
u
u
N
u
H
H
h
u
K
u
u
u
u
u
u
H
a
a
a
"}
(18,1,1) = {"
a
a
a
a
a
a
u
u
H
H
u
u
u
u
u
u
N
u
z
u
e
u
N
u
u
u
u
u
u
z
u
u
u
u
h
u
u
N
u
H
a
a
a
"}
(19,1,1) = {"
a
a
a
a
a
a
a
u
H
H
u
u
F
u
u
u
u
u
u
u
e
u
u
u
u
u
u
u
u
u
u
N
u
u
u
z
u
u
z
H
H
a
a
"}
(20,1,1) = {"
a
a
a
a
a
a
a
u
u
u
N
u
u
u
u
N
u
u
u
u
k
k
k
k
k
k
k
u
u
u
u
u
u
u
u
u
u
u
u
u
H
a
a
"}
(21,1,1) = {"
a
a
a
a
a
a
u
N
u
u
u
u
H
H
u
u
u
u
u
a
a
a
a
a
a
a
a
a
a
a
a
a
u
u
N
N
u
u
N
u
H
a
a
"}
(22,1,1) = {"
a
a
a
a
a
a
u
u
u
u
u
u
H
H
u
a
u
N
u
u
a
a
a
a
a
a
a
a
a
a
a
a
a
u
u
u
u
u
u
u
H
a
a
"}
(23,1,1) = {"
a
a
a
a
a
a
a
a
u
u
N
u
u
u
u
a
a
a
a
a
a
a
a
a
a
a
a
a
a
a
a
a
a
a
u
u
u
u
u
u
u
u
a
"}
(24,1,1) = {"
a
a
a
a
a
a
a
u
u
u
u
u
u
N
u
V
b
b
b
b
V
V
V
V
a
a
a
a
a
a
a
a
a
k
G
k
u
u
N
u
N
u
a
"}
(25,1,1) = {"
a
a
a
a
a
a
u
u
u
u
u
z
u
u
u
c
u
u
z
k
k
a
a
V
a
a
a
a
a
a
a
a
k
G
t
G
k
u
u
u
u
u
a
"}
(26,1,1) = {"
a
a
a
a
u
u
u
N
H
H
u
u
u
u
u
c
u
u
u
u
k
k
a
V
a
a
a
a
a
a
a
k
G
G
G
G
G
k
u
u
u
u
a
"}
(27,1,1) = {"
a
a
a
a
l
u
u
u
H
H
u
N
u
u
u
f
u
u
u
N
u
k
k
V
a
a
a
a
a
a
a
k
Z
G
Z
G
G
k
z
u
u
u
v
"}
(28,1,1) = {"
a
a
a
a
a
u
u
u
u
u
u
u
u
u
u
b
u
u
u
u
u
u
k
V
a
a
a
a
a
a
a
k
G
t
G
t
G
k
u
u
u
u
v
"}
(29,1,1) = {"
a
a
a
a
a
u
u
N
u
u
u
u
u
u
a
b
u
u
u
u
u
u
k
V
a
a
a
a
a
a
a
H
k
G
G
G
k
u
u
N
u
u
M
"}
(30,1,1) = {"
a
a
a
a
z
u
u
u
K
u
u
z
u
a
a
b
N
u
u
C
u
u
k
V
a
a
a
a
a
a
a
H
H
k
G
k
u
u
u
u
u
u
v
"}
(31,1,1) = {"
k
k
k
u
u
u
u
u
u
u
u
H
z
a
a
b
u
u
u
u
N
u
k
V
a
a
a
a
a
a
a
u
u
u
N
u
u
u
z
u
u
u
v
"}
(32,1,1) = {"
k
m
u
u
u
N
u
u
u
u
N
u
u
u
a
b
u
u
u
u
u
u
k
V
a
a
a
a
a
a
a
a
u
u
u
u
u
z
u
u
k
k
k
"}
(33,1,1) = {"
k
u
u
u
u
u
u
H
H
H
u
u
u
u
a
b
u
u
u
u
u
k
k
V
a
a
a
a
a
a
a
a
a
u
z
u
z
u
u
u
u
u
v
"}
(34,1,1) = {"
k
u
N
u
u
u
u
N
H
H
u
u
u
N
u
b
b
u
u
N
u
k
a
V
a
a
a
a
a
a
a
a
a
a
a
z
H
H
N
u
N
u
v
"}
(35,1,1) = {"
k
u
u
H
z
u
u
u
u
z
u
u
u
u
u
H
b
b
z
u
k
k
a
V
a
a
a
a
a
a
a
a
a
a
a
u
u
H
H
u
u
K
v
"}
(36,1,1) = {"
k
u
u
u
u
u
H
u
S
u
g
u
z
N
u
H
H
b
b
b
b
V
V
V
a
a
a
a
a
a
a
a
a
a
u
u
N
u
u
u
u
u
v
"}
(37,1,1) = {"
k
u
u
N
u
u
H
u
u
u
u
u
H
z
u
u
u
a
a
a
a
a
a
a
a
a
a
a
a
a
a
a
a
a
u
u
u
u
a
a
H
u
v
"}
(38,1,1) = {"
k
i
u
u
u
u
u
u
w
u
S
u
u
u
u
u
u
a
a
a
a
a
a
a
a
a
a
a
a
a
a
a
a
u
u
u
u
k
a
a
H
H
q
"}
(39,1,1) = {"
k
k
k
u
N
u
u
u
u
u
u
u
u
N
u
u
N
H
a
a
a
a
a
a
a
a
a
a
a
a
a
a
u
u
u
N
u
k
a
a
a
H
a
"}
(40,1,1) = {"
a
a
a
u
u
u
u
u
S
u
S
u
H
H
e
e
e
H
a
a
a
a
a
a
a
a
a
u
H
H
H
H
u
u
u
u
a
a
a
a
a
a
a
"}
(41,1,1) = {"
a
a
a
u
z
u
u
N
u
u
u
H
H
H
u
u
u
u
u
a
a
a
a
u
u
a
u
u
u
u
u
e
u
N
u
z
a
a
a
a
a
a
a
"}
(42,1,1) = {"
a
a
a
z
u
H
u
u
S
u
S
u
H
H
u
u
u
N
u
u
a
z
u
u
u
e
z
u
u
N
u
e
u
u
z
a
a
a
a
a
a
a
a
"}
(43,1,1) = {"
a
a
a
O
H
H
u
u
N
u
u
u
u
H
u
u
u
u
u
u
z
u
u
u
N
e
u
u
u
u
u
e
u
u
a
a
a
a
a
a
a
a
a
"}
(44,1,1) = {"
a
a
a
z
u
u
u
u
g
u
g
u
u
e
u
u
F
u
u
z
u
N
u
u
u
e
N
u
u
u
u
a
a
a
a
a
a
a
a
a
a
a
a
"}
(45,1,1) = {"
a
a
a
a
u
u
u
u
u
u
u
u
N
e
u
u
u
K
u
u
u
u
u
u
u
e
u
u
u
a
a
a
a
a
R
R
R
a
a
a
R
R
R
"}
(46,1,1) = {"
a
a
a
a
u
N
u
u
u
H
H
u
u
e
u
u
N
u
u
u
u
z
u
u
u
e
u
u
u
J
J
J
J
J
J
J
J
V
V
V
J
J
J
"}
(47,1,1) = {"
a
a
a
a
u
u
u
u
u
u
H
H
u
e
u
u
u
u
u
H
H
u
z
u
N
e
u
u
R
J
R
R
R
R
R
R
R
a
a
a
R
R
R
"}
(48,1,1) = {"
a
a
a
a
u
u
u
u
u
u
H
H
H
H
H
H
H
u
u
u
u
u
u
u
u
e
u
u
R
J
R
R
R
R
R
R
R
a
a
a
R
R
R
"}
(49,1,1) = {"
a
a
a
a
u
u
u
u
N
u
u
H
H
H
u
u
H
u
H
N
u
H
H
H
H
H
R
R
R
J
R
R
R
R
R
R
R
a
a
a
R
R
R
"}
(50,1,1) = {"
a
a
a
a
a
u
u
u
z
u
u
u
u
N
z
u
H
u
u
u
u
H
a
a
a
a
a
a
a
V
a
a
a
a
a
a
a
a
a
a
a
a
a
"}
(51,1,1) = {"
a
a
a
a
a
a
H
u
u
u
u
u
u
u
u
H
H
e
e
e
H
H
a
a
a
a
V
V
V
V
a
a
a
a
a
a
a
a
a
a
a
a
a
"}
(52,1,1) = {"
a
a
a
a
a
a
u
u
u
u
H
H
H
u
u
H
H
u
u
u
u
u
u
a
a
a
V
a
a
k
k
k
k
k
k
k
k
k
k
k
a
a
a
"}
(53,1,1) = {"
a
a
a
a
a
a
u
u
u
H
H
H
H
u
N
H
H
u
N
u
u
u
u
u
k
k
b
k
k
E
E
E
E
E
E
E
E
E
E
k
k
k
k
"}
(54,1,1) = {"
a
a
a
a
a
a
u
u
N
H
H
H
H
u
u
H
H
u
u
u
u
u
u
u
u
u
A
E
E
E
r
E
E
X
E
E
E
E
E
E
E
E
d
"}
(55,1,1) = {"
a
a
a
a
a
a
u
u
u
H
H
H
H
u
u
H
H
z
u
u
N
u
z
N
u
u
A
E
E
X
B
E
r
E
E
E
E
B
E
E
E
B
d
"}
(56,1,1) = {"
a
a
a
a
a
a
u
u
u
u
u
H
u
u
u
N
u
u
u
u
u
u
u
u
u
u
A
E
E
r
E
r
E
E
E
E
X
E
E
E
X
E
d
"}
(57,1,1) = {"
a
a
a
a
a
a
u
u
z
u
u
u
u
u
z
u
u
z
u
u
u
u
u
k
k
k
b
k
k
E
E
E
E
E
E
E
E
E
E
E
E
E
d
"}
(58,1,1) = {"
a
a
a
a
a
a
N
u
u
u
N
u
u
z
u
u
u
u
N
u
u
a
a
a
a
a
V
a
a
k
E
E
E
E
X
E
E
E
E
E
E
E
d
"}
(59,1,1) = {"
a
a
a
a
a
a
H
H
u
u
u
u
u
u
N
u
u
u
u
u
a
a
a
a
a
a
V
a
a
k
P
P
P
d
d
E
P
P
d
d
d
d
d
"}
(60,1,1) = {"
a
a
a
a
a
a
a
H
H
H
H
u
u
u
u
u
u
u
u
a
a
a
a
a
a
a
V
a
a
k
P
P
P
P
P
P
P
j
P
P
P
j
P
"}
(61,1,1) = {"
a
a
a
a
a
a
a
a
a
a
a
a
u
u
u
u
u
a
a
a
R
R
R
a
a
R
J
R
a
k
n
j
P
P
P
P
L
P
P
P
P
P
P
"}
(62,1,1) = {"
a
a
a
a
a
a
a
a
a
a
a
a
a
e
e
W
e
a
a
a
R
R
R
a
a
R
J
R
a
a
P
n
P
P
P
P
P
n
P
P
P
j
P
"}
