//MAP CONVERTED BY dmm2tgm.py THIS HEADER COMMENT PREVENTS RECONVERSION, DO NOT REMOVE
"mR" = (
/obj/docking_port/mobile/marine_dropship/one,
/turf/open/floor/plating/ground/dirt,
/area/space)
"pa" = (
/obj/effect/spawner/modularmap/shuttle/alamo,
/turf/open/space/basic,
/area/space)
"Zx" = (
/turf/open/space/basic,
/area/space)

(1,1,1) = {"
Zx
Zx
Zx
Zx
Zx
Zx
Zx
Zx
Zx
Zx
Zx
Zx
Zx
Zx
Zx
Zx
Zx
Zx
Zx
Zx
pa
"}
(2,1,1) = {"
Zx
Zx
Zx
Zx
Zx
Zx
Zx
Zx
Zx
Zx
Zx
Zx
Zx
Zx
Zx
Zx
Zx
Zx
Zx
Zx
Zx
"}
(3,1,1) = {"
Zx
Zx
Zx
Zx
Zx
Zx
Zx
Zx
Zx
Zx
Zx
Zx
Zx
Zx
Zx
Zx
Zx
Zx
Zx
Zx
Zx
"}
(4,1,1) = {"
Zx
Zx
Zx
Zx
Zx
Zx
Zx
Zx
Zx
Zx
Zx
Zx
Zx
Zx
Zx
Zx
Zx
Zx
Zx
Zx
Zx
"}
(5,1,1) = {"
Zx
Zx
Zx
Zx
Zx
Zx
Zx
Zx
Zx
Zx
Zx
Zx
Zx
Zx
Zx
Zx
Zx
Zx
Zx
Zx
Zx
"}
(6,1,1) = {"
Zx
Zx
Zx
Zx
Zx
Zx
Zx
Zx
Zx
Zx
mR
Zx
Zx
Zx
Zx
Zx
Zx
Zx
Zx
Zx
Zx
"}
(7,1,1) = {"
Zx
Zx
Zx
Zx
Zx
Zx
Zx
Zx
Zx
Zx
Zx
Zx
Zx
Zx
Zx
Zx
Zx
Zx
Zx
Zx
Zx
"}
(8,1,1) = {"
Zx
Zx
Zx
Zx
Zx
Zx
Zx
Zx
Zx
Zx
Zx
Zx
Zx
Zx
Zx
Zx
Zx
Zx
Zx
Zx
Zx
"}
(9,1,1) = {"
Zx
Zx
Zx
Zx
Zx
Zx
Zx
Zx
Zx
Zx
Zx
Zx
Zx
Zx
Zx
Zx
Zx
Zx
Zx
Zx
Zx
"}
(10,1,1) = {"
Zx
Zx
Zx
Zx
Zx
Zx
Zx
Zx
Zx
Zx
Zx
Zx
Zx
Zx
Zx
Zx
Zx
Zx
Zx
Zx
Zx
"}
(11,1,1) = {"
Zx
Zx
Zx
Zx
Zx
Zx
Zx
Zx
Zx
Zx
Zx
Zx
Zx
Zx
Zx
Zx
Zx
Zx
Zx
Zx
Zx
"}
